[  ][  ][  ][  ][  ][B ][  ][  ][  ][  ][  ][  ][  ][  ][  ][  ]
[  ][Wd][  ][Hd][  ][B ][  ][Hu][  ][  ][Wr][D ][Wl][Wu][  ][  ]
[  ][  ][  ][  ][  ][  ][  ][Hd][  ][  ][  ][  ][  ][  ][  ][Ex]
[  ][  ][B ][  ][  ][B ][  ][  ][  ][  ][Wr][  ][B ][  ][  ][  ]
[  ][Wu][  ][  ][Wl][  ][  ][  ][  ][  ][  ][  ][  ][  ][  ][B ]
[B ][  ][B ][  ][Wl][  ][  ][  ][  ][  ][  ][  ][Hr][  ][Wu][  ]
[  ][  ][  ][  ][  ][  ][B ][Hr][  ][  ][  ][  ][  ][  ][  ][  ]
[  ][  ][  ][  ][  ][  ][  ][  ][  ][B ][Hl][Wl][  ][  ][  ][  ]
[  ][  ][  ][  ][  ][  ][Wl][  ][  ][B ][  ][  ][  ][  ][Wd][  ]
