[  ][  ][  ][  ][Hu][  ][  ][  ][  ][B ][  ][  ][  ][  ][  ][  ]
[  ][  ][Wu][  ][  ][  ][  ][  ][  ][  ][  ][  ][Hu][  ][  ][  ]
[  ][  ][  ][  ][  ][Hd][  ][  ][  ][Hr][Wl][Hd][  ][  ][  ][  ]
[  ][Wr][  ][  ][  ][  ][  ][  ][  ][  ][  ][  ][  ][  ][  ][  ]
[  ][  ][Wu][  ][  ][  ][  ][  ][  ][  ][  ][  ][  ][  ][  ][  ]
[  ][  ][  ][Wr][B ][  ][  ][  ][  ][  ][  ][  ][Hu][  ][  ][  ]
[Hl][  ][Hr][Ex][  ][  ][  ][Wl][  ][  ][  ][  ][  ][  ][  ][  ]
[  ][  ][  ][  ][  ][  ][  ][  ][  ][Wd][  ][  ][  ][  ][Hu][  ]
[  ][  ][  ][  ][B ][D ][  ][  ][  ][  ][  ][  ][  ][B ][Wd][  ]
