[  ][Wd][Hd][Wd][Hl][Hr][  ][  ][  ][  ][  ][Wl][  ][  ][  ][  ]
[  ][  ][Hr][  ][Hr][  ][B ][  ][Hl][  ][  ][Wd][B ][Wl][  ][Hr]
[Wr][  ][Hr][  ][  ][Hd][  ][  ][B ][  ][  ][Hr][  ][  ][  ][  ]
[  ][Wr][Hu][  ][B ][Wl][  ][Wd][  ][  ][Hr][  ][Hl][  ][Wd][B ]
[  ][Wd][  ][  ][Hr][B ][  ][  ][Wd][Hl][  ][Hl][  ][  ][  ][B ]
[  ][  ][  ][Hr][B ][Wd][  ][Wd][  ][  ][  ][Wd][  ][B ][  ][  ]
[B ][  ][  ][Ex][  ][  ][  ][  ][Wd][Wd][B ][  ][  ][  ][  ][  ]
[  ][  ][  ][  ][  ][  ][Hl][Wd][  ][Wr][  ][B ][  ][  ][  ][  ]
[  ][  ][  ][Wu][B ][D ][Wl][  ][Hd][B ][Wr][  ][B ][  ][Wd][B ]
