[  ][Hd][  ][Wl][Hu][Hr][  ][  ][  ][  ][  ][  ][  ][  ][Hu][  ]
[  ][  ][  ][  ][  ][  ][  ][  ][  ][  ][  ][Wd][Hu][Wl][  ][Hr]
[Wr][  ][  ][  ][  ][Hd][  ][B ][  ][  ][Wl][Hd][  ][  ][  ][Hl]
[  ][Wr][  ][  ][B ][Wl][Hd][Hr][  ][Hl][  ][  ][Wd][Wd][Hr][B ]
[  ][  ][  ][  ][Hr][B ][B ][Hd][  ][  ][  ][  ][  ][Wr][  ][  ]
[  ][  ][Wl][Wr][B ][  ][Hr][Wd][  ][  ][  ][  ][  ][B ][  ][  ]
[B ][  ][  ][Ex][  ][  ][  ][Wl][  ][  ][Wu][  ][  ][Hu][  ][B ]
[  ][  ][  ][Hl][  ][  ][  ][  ][  ][Wr][  ][B ][  ][  ][Hu][  ]
[Wr][  ][Hr][B ][B ][D ][  ][  ][  ][  ][Wr][  ][  ][  ][Wd][B ]
