[  ][Hd][Hr][Wl][Hu][Hr][  ][  ][  ][  ][  ][B ][Wu][  ][Hu][  ]
[  ][Hl][  ][  ][Wd][  ][B ][  ][  ][  ][B ][Wd][B ][Wl][  ][  ]
[Wr][B ][Hr][  ][  ][Hd][  ][  ][  ][  ][Wl][Hr][  ][  ][  ][  ]
[  ][  ][Hu][  ][B ][Wl][  ][Hr][  ][Hl][Hr][  ][Hd][Wd][Wd][B ]
[  ][  ][  ][  ][Hr][B ][  ][  ][  ][  ][  ][  ][  ][  ][  ][Wr]
[  ][  ][  ][Hr][B ][  ][  ][Wd][  ][  ][  ][Wd][  ][B ][  ][  ]
[B ][  ][  ][Ex][  ][  ][  ][Wl][Wd][Wd][B ][  ][  ][  ][  ][Wl]
[  ][  ][  ][Hl][  ][  ][Hl][  ][  ][Wr][  ][B ][  ][  ][Hu][  ]
[Wr][B ][  ][  ][B ][D ][  ][Hu][  ][B ][Wr][  ][  ][  ][Wd][B ]
