[  ][Hd][  ][Hu][Hu][  ][  ][  ][  ][  ][  ][  ][  ][  ][  ][  ]
[  ][  ][  ][  ][  ][  ][  ][  ][  ][  ][  ][Wd][Hu][Wl][  ][Hr]
[Wr][B ][  ][  ][  ][Hd][  ][B ][  ][  ][Wl][Hd][  ][  ][  ][Hl]
[  ][Wr][  ][  ][B ][Wl][Hd][Hr][  ][Hl][  ][  ][Wd][Wd][  ][B ]
[  ][  ][  ][  ][Hr][B ][B ][Hd][  ][  ][  ][  ][  ][Hd][  ][  ]
[  ][Wr][Wl][Wr][B ][  ][  ][Wd][  ][  ][  ][  ][  ][B ][  ][  ]
[B ][  ][  ][Ex][  ][  ][  ][Wl][  ][  ][Wu][  ][  ][Hu][  ][B ]
[  ][  ][  ][Hl][  ][  ][  ][  ][  ][Wr][  ][B ][B ][  ][Hu][  ]
[Wr][  ][Hr][B ][  ][D ][  ][  ][  ][  ][Wr][  ][  ][  ][Wd][B ]
