[  ][Hr][  ][  ][Hu][Hr][  ][  ][  ][Hu][  ][  ][Wl][  ][  ][  ]
[  ][B ][Wu][Wl][  ][  ][  ][  ][  ][  ][  ][  ][  ][  ][  ][Wl]
[  ][  ][  ][  ][  ][Hr][  ][  ][B ][  ][Wl][Hd][  ][  ][  ][Hl]
[  ][Wr][  ][B ][B ][Wd][  ][Wl][  ][  ][  ][Hl][  ][  ][  ][  ]
[  ][  ][  ][  ][Hr][  ][  ][Wu][  ][  ][  ][  ][  ][  ][  ][  ]
[  ][  ][  ][Wr][Hd][  ][Hl][  ][  ][Hr][  ][  ][  ][  ][  ][  ]
[Hl][B ][Hr][Ex][  ][  ][  ][B ][  ][  ][  ][  ][  ][  ][  ][  ]
[B ][  ][  ][  ][  ][  ][  ][  ][B ][Wd][  ][  ][  ][  ][Hu][  ]
[  ][  ][  ][  ][B ][D ][  ][Hl][  ][  ][  ][  ][  ][B ][Wd][  ]
