[  ][Wd][Hr][Wd][Hu][Hr][  ][  ][  ][  ][  ][Wl][Wu][  ][Hu][  ]
[  ][  ][Hr][  ][Wu][  ][B ][  ][  ][  ][B ][Wd][B ][Wl][  ][Hr]
[Wr][  ][Hr][  ][  ][Hd][  ][  ][  ][  ][  ][Hr][  ][  ][  ][  ]
[  ][Wr][Hu][  ][B ][Wl][B ][Hr][  ][Hl][Hr][  ][  ][Wd][Wd][B ]
[  ][  ][  ][  ][Hr][B ][  ][Hd][Hd][  ][Hl][Hl][  ][  ][  ][B ]
[  ][  ][  ][Hr][B ][Wd][  ][Wd][  ][  ][  ][Wd][  ][B ][  ][  ]
[B ][  ][  ][Ex][  ][  ][  ][Wl][Wd][Wd][B ][  ][  ][  ][  ][  ]
[  ][  ][  ][Wd][  ][  ][  ][  ][Hl][Wr][  ][B ][  ][  ][  ][  ]
[Wr][  ][  ][  ][B ][D ][  ][  ][Hd][B ][Wr][  ][  ][  ][Wd][B ]
