[Wl][  ][  ][  ][Hu][Hr][  ][  ][  ][B ][  ][  ][Wl][Wl][  ][Wu]
[  ][  ][Wu][  ][  ][  ][  ][  ][B ][  ][  ][  ][  ][  ][  ][  ]
[  ][B ][  ][  ][  ][Hd][  ][  ][B ][  ][Wl][  ][  ][  ][  ][Hl]
[  ][Wu][  ][  ][B ][  ][  ][  ][  ][  ][  ][  ][  ][  ][  ][  ]
[  ][  ][  ][  ][Hr][  ][  ][  ][  ][  ][  ][  ][  ][  ][  ][B ]
[Hl][  ][B ][Wr][  ][  ][  ][  ][  ][Hr][  ][  ][  ][  ][  ][  ]
[Hl][  ][Hr][Ex][  ][B ][Hr][  ][  ][  ][  ][  ][  ][  ][B ][  ]
[  ][  ][  ][Hu][  ][  ][  ][  ][  ][  ][  ][  ][  ][  ][Hu][  ]
[  ][  ][  ][  ][B ][D ][  ][  ][  ][Hl][  ][  ][B ][B ][Wd][  ]
