[  ][Hd][  ][Wl][Hu][Hr][  ][  ][  ][  ][  ][  ][  ][  ][Hu][  ]
[  ][  ][Wu][  ][  ][  ][  ][  ][  ][  ][  ][Wd][Hu][Wl][  ][Hr]
[Wr][B ][  ][  ][  ][Hd][  ][  ][  ][  ][Wl][Hd][  ][  ][  ][  ]
[  ][Wr][  ][  ][B ][Wl][  ][Hr][  ][Hl][  ][  ][Wd][Wd][  ][  ]
[  ][  ][  ][  ][Hr][B ][  ][  ][  ][  ][  ][  ][  ][  ][  ][  ]
[  ][  ][  ][Wr][B ][  ][  ][Wd][  ][  ][  ][  ][  ][B ][  ][  ]
[B ][  ][  ][Ex][  ][  ][  ][Wl][Wd][  ][Wu][  ][B ][  ][  ][  ]
[  ][  ][  ][Hl][  ][  ][  ][  ][  ][Wr][  ][B ][  ][  ][Hu][  ]
[Wr][  ][  ][B ][B ][D ][  ][  ][  ][  ][Wr][  ][  ][  ][Wd][B ]
