[Wl][  ][  ][  ][Hu][Hr][  ][  ][  ][B ][  ][  ][Wl][Wl][  ][Wu]
[  ][  ][Wu][  ][  ][  ][  ][  ][B ][  ][  ][  ][  ][  ][  ][  ]
[  ][B ][  ][  ][  ][Hd][  ][  ][B ][  ][  ][  ][  ][  ][  ][Hl]
[  ][Wu][  ][  ][B ][  ][  ][  ][  ][  ][  ][  ][  ][  ][  ][  ]
[  ][  ][  ][  ][Hr][  ][  ][  ][  ][  ][  ][  ][  ][  ][  ][B ]
[Hl][  ][  ][Wr][B ][  ][  ][  ][  ][Hr][  ][  ][  ][  ][  ][  ]
[Hl][  ][Hr][Ex][  ][B ][Hr][  ][  ][  ][  ][  ][  ][  ][B ][  ]
[  ][  ][  ][Hu][  ][  ][  ][  ][  ][  ][  ][  ][  ][  ][Hu][  ]
[  ][  ][  ][  ][B ][D ][  ][  ][  ][Hl][  ][  ][B ][B ][Wd][Wu]
