[D ][  ][  ][  ][  ][  ][  ][  ][  ][  ][Hl][  ][  ][  ][  ][Wu]
[  ][Hd][  ][  ][  ][  ][Wu][  ][  ][  ][  ][Hd][Wd][  ][  ][  ]
[  ][  ][Hl][  ][  ][  ][  ][  ][  ][  ][  ][B ][  ][  ][  ][  ]
[B ][  ][  ][  ][  ][  ][  ][  ][  ][  ][  ][  ][  ][  ][  ][  ]
[  ][Wl][  ][  ][  ][  ][  ][  ][  ][  ][Wu][  ][  ][  ][  ][  ]
[  ][  ][  ][  ][  ][  ][  ][  ][  ][  ][  ][  ][  ][  ][  ][  ]
[  ][  ][  ][B ][  ][  ][Wr][  ][  ][  ][  ][  ][  ][B ][  ][  ]
[  ][  ][  ][Hd][  ][  ][  ][  ][  ][B ][  ][  ][  ][  ][  ][  ]
[  ][  ][B ][  ][  ][  ][Hu][  ][  ][  ][  ][  ][  ][  ][  ][Ex]
