[D ][  ][  ][B ][  ][  ][  ][  ][  ][  ][  ][  ][  ][  ][  ][  ]
[  ][  ][  ][  ][  ][Wd][  ][  ][  ][  ][  ][  ][  ][  ][  ][  ]
[  ][  ][  ][  ][  ][  ][  ][  ][  ][  ][  ][  ][  ][  ][  ][  ]
[  ][  ][  ][  ][  ][  ][  ][  ][Wl][  ][  ][  ][  ][  ][  ][  ]
[  ][  ][  ][  ][  ][Wu][Wr][  ][  ][  ][  ][  ][  ][  ][  ][  ]
[  ][  ][  ][  ][  ][  ][  ][  ][  ][  ][  ][  ][  ][  ][B ][  ]
[  ][  ][  ][  ][  ][Hl][  ][  ][  ][  ][  ][  ][  ][  ][  ][  ]
[  ][  ][Hr][  ][  ][  ][  ][  ][  ][  ][  ][  ][  ][  ][  ][  ]
[  ][  ][  ][  ][  ][  ][  ][  ][  ][  ][  ][  ][  ][Wd][  ][Ex]
