[D ][  ][  ][  ][  ][  ][  ][  ][  ][  ][  ][  ][  ][Hu][Wr][  ]
[  ][  ][  ][  ][  ][  ][  ][  ][  ][  ][  ][  ][  ][  ][  ][  ]
[  ][  ][  ][  ][  ][  ][  ][  ][  ][  ][  ][B ][  ][  ][  ][  ]
[  ][  ][  ][  ][  ][  ][  ][  ][  ][  ][  ][  ][  ][  ][  ][  ]
[  ][  ][  ][  ][  ][  ][  ][  ][  ][  ][  ][  ][  ][  ][  ][  ]
[  ][  ][  ][  ][  ][  ][  ][  ][  ][  ][  ][  ][Hr][  ][  ][  ]
[  ][  ][  ][  ][  ][  ][  ][  ][  ][  ][  ][  ][  ][  ][  ][  ]
[  ][  ][  ][  ][  ][Hu][  ][  ][  ][  ][  ][B ][  ][  ][  ][  ]
[  ][  ][B ][  ][  ][  ][  ][Hl][  ][  ][  ][  ][  ][  ][  ][Ex]
