[D ][  ][Hu][  ][  ][  ][  ][  ][  ][  ][  ][  ][  ][  ][  ][  ]
[  ][  ][  ][  ][  ][  ][  ][  ][Wr][  ][  ][  ][  ][  ][  ][  ]
[  ][Hu][  ][  ][  ][  ][  ][  ][  ][  ][  ][  ][B ][  ][  ][B ]
[  ][  ][  ][  ][  ][  ][  ][  ][  ][  ][  ][  ][  ][  ][  ][  ]
[  ][  ][  ][  ][  ][  ][  ][  ][  ][  ][  ][  ][  ][  ][  ][  ]
[  ][  ][  ][  ][  ][  ][  ][  ][Wl][  ][  ][  ][  ][  ][  ][  ]
[  ][  ][  ][  ][Wl][  ][  ][  ][  ][  ][  ][  ][  ][  ][B ][  ]
[  ][  ][  ][  ][  ][  ][  ][  ][  ][  ][  ][  ][  ][  ][  ][  ]
[  ][  ][  ][  ][  ][  ][  ][  ][  ][  ][  ][  ][  ][  ][  ][Ex]
