[D ][  ][  ][  ][  ][  ][  ][Wr][  ][  ][  ][  ][B ][  ][B ][  ]
[  ][  ][  ][  ][  ][  ][B ][  ][  ][  ][  ][  ][  ][  ][  ][  ]
[  ][  ][  ][  ][  ][  ][  ][Hl][  ][  ][  ][  ][B ][B ][Hl][  ]
[  ][  ][  ][Hr][B ][  ][  ][  ][  ][  ][  ][  ][  ][  ][  ][  ]
[  ][  ][Hl][  ][  ][  ][  ][  ][  ][  ][  ][  ][Hd][  ][  ][  ]
[  ][  ][  ][  ][  ][  ][  ][  ][B ][Hd][  ][  ][  ][Hr][  ][  ]
[  ][  ][  ][  ][  ][  ][  ][B ][Wl][  ][Wd][  ][  ][  ][  ][  ]
[B ][  ][  ][  ][  ][  ][  ][  ][  ][  ][  ][  ][  ][  ][B ][Wl]
[  ][  ][  ][B ][Hd][B ][  ][Hl][  ][  ][B ][  ][  ][  ][  ][Ex]
