[D ][  ][  ][  ][  ][  ][  ][Wr][  ][  ][  ][  ][  ][  ][B ][  ]
[B ][  ][  ][  ][  ][  ][B ][  ][  ][  ][  ][  ][  ][  ][  ][  ]
[  ][  ][  ][  ][  ][  ][  ][Hl][  ][  ][  ][  ][  ][B ][  ][  ]
[  ][  ][  ][  ][B ][  ][  ][  ][  ][  ][  ][  ][  ][  ][  ][  ]
[  ][  ][Hl][  ][  ][  ][  ][  ][  ][  ][  ][  ][Hd][  ][  ][  ]
[  ][  ][  ][  ][  ][  ][  ][  ][  ][Hd][  ][  ][B ][Hr][  ][  ]
[  ][  ][B ][  ][  ][  ][  ][  ][  ][  ][  ][  ][  ][  ][  ][  ]
[B ][  ][  ][  ][  ][  ][  ][  ][  ][  ][  ][  ][  ][  ][B ][  ]
[Hr][  ][  ][  ][Hd][B ][  ][  ][  ][  ][Hu][  ][  ][  ][  ][Ex]
