[D ][  ][  ][Hu][  ][  ][B ][  ][  ][  ][  ][  ][  ][  ][  ][Wl]
[  ][  ][  ][Wl][  ][  ][  ][  ][  ][  ][  ][Wd][  ][B ][  ][  ]
[  ][B ][  ][  ][  ][  ][  ][  ][  ][  ][  ][  ][  ][  ][B ][B ]
[  ][Wu][  ][  ][  ][  ][Wd][  ][Wr][  ][Wr][B ][  ][  ][  ][  ]
[  ][  ][  ][  ][  ][  ][  ][  ][Wd][Wd][  ][  ][Hd][  ][  ][  ]
[  ][  ][  ][Wl][  ][  ][  ][  ][Hl][  ][  ][  ][B ][Wr][  ][  ]
[  ][  ][B ][  ][  ][  ][  ][B ][Wl][  ][  ][  ][  ][  ][  ][  ]
[Wu][  ][  ][  ][  ][  ][  ][Wu][  ][  ][  ][  ][  ][  ][  ][  ]
[  ][  ][Wd][B ][Hd][B ][  ][Wl][  ][  ][  ][  ][  ][  ][  ][Ex]
