[D ][  ][  ][  ][  ][  ][  ][  ][  ][  ][  ][Wd][  ][  ][  ][Wl]
[  ][  ][  ][  ][  ][  ][Hd][  ][  ][  ][  ][  ][  ][  ][  ][  ]
[  ][  ][Wr][  ][Hr][  ][  ][  ][  ][  ][  ][  ][  ][  ][  ][Wr]
[  ][  ][  ][  ][  ][  ][Wd][  ][  ][  ][Wr][Hu][  ][  ][  ][  ]
[  ][  ][  ][  ][Hl][  ][  ][  ][  ][Hr][B ][  ][  ][  ][  ][Wu]
[  ][B ][  ][  ][  ][  ][  ][Wl][B ][  ][  ][  ][  ][B ][  ][  ]
[  ][Wu][  ][  ][  ][  ][  ][B ][Hu][  ][B ][  ][  ][  ][  ][  ]
[  ][  ][  ][  ][  ][  ][  ][B ][B ][  ][  ][  ][  ][Wu][  ][  ]
[Hu][  ][Hd][B ][Hd][  ][  ][Hd][  ][B ][  ][  ][  ][Wu][Wd][Ex]
