[D ][  ][  ][  ][  ][  ][Wd][  ][  ][  ][Wl][  ][B ][  ][B ][  ]
[  ][  ][  ][  ][  ][  ][B ][  ][  ][  ][  ][  ][  ][  ][  ][  ]
[  ][  ][Wu][  ][Hr][  ][Hu][  ][  ][  ][Wr][B ][  ][  ][  ][  ]
[  ][  ][  ][  ][Hu][  ][  ][  ][  ][  ][B ][  ][  ][  ][  ][  ]
[  ][  ][B ][  ][  ][  ][  ][  ][  ][  ][  ][  ][Hr][  ][  ][  ]
[B ][  ][  ][  ][Wl][  ][  ][  ][B ][Hd][  ][B ][Hl][B ][Wd][  ]
[  ][  ][  ][  ][  ][  ][  ][  ][  ][Wd][  ][Hu][  ][  ][  ][  ]
[Hr][  ][  ][  ][Hl][  ][  ][  ][  ][  ][  ][  ][  ][  ][Wl][Wl]
[  ][  ][  ][  ][Hd][  ][  ][Wd][  ][  ][B ][  ][  ][B ][  ][Ex]
