[D ][  ][  ][  ][  ][  ][  ][  ][  ][  ][  ][B ][  ][  ][  ][Wl]
[  ][  ][Hd][  ][  ][  ][  ][  ][  ][  ][  ][  ][  ][  ][  ][B ]
[  ][  ][  ][  ][Hr][  ][  ][  ][  ][B ][B ][  ][  ][  ][  ][  ]
[  ][  ][  ][  ][  ][  ][Wd][  ][  ][  ][  ][Hu][  ][  ][  ][  ]
[Hl][  ][  ][  ][  ][  ][B ][  ][  ][  ][  ][  ][B ][  ][B ][Wu]
[  ][  ][  ][  ][  ][  ][  ][  ][  ][  ][B ][  ][  ][B ][  ][  ]
[  ][  ][  ][  ][  ][  ][  ][B ][Hr][  ][B ][  ][  ][  ][Hu][  ]
[Wu][  ][  ][  ][  ][  ][  ][B ][  ][  ][  ][  ][  ][  ][  ][  ]
[  ][Hl][Hd][B ][Hd][  ][  ][Hd][  ][  ][  ][  ][  ][  ][  ][Ex]
