[D ][  ][  ][  ][B ][  ][Wd][  ][  ][  ][  ][  ][  ][  ][  ][  ]
[  ][  ][B ][Wr][  ][Hl][  ][  ][Hd][  ][  ][Hu][  ][  ][  ][  ]
[  ][  ][Hl][  ][  ][B ][  ][  ][  ][  ][  ][  ][  ][  ][Wr][Hu]
[  ][  ][  ][  ][  ][  ][  ][  ][Hr][  ][Hd][  ][B ][  ][  ][  ]
[  ][  ][  ][  ][  ][  ][  ][  ][B ][  ][  ][  ][B ][  ][  ][B ]
[  ][Hd][  ][  ][  ][  ][  ][  ][  ][  ][Wr][  ][  ][  ][  ][  ]
[  ][  ][  ][  ][  ][  ][  ][  ][  ][  ][  ][  ][  ][Hr][Wr][  ]
[  ][  ][  ][  ][  ][  ][  ][  ][  ][  ][  ][  ][  ][  ][  ][  ]
[  ][B ][  ][  ][  ][  ][  ][  ][  ][  ][  ][  ][  ][  ][  ][Ex]
