[D ][  ][  ][  ][  ][  ][  ][Wr][  ][Hu][  ][  ][B ][  ][B ][  ]
[  ][  ][  ][  ][  ][  ][B ][  ][  ][  ][  ][  ][  ][  ][  ][  ]
[  ][  ][Wu][  ][Hr][Wd][  ][Hl][  ][B ][  ][  ][B ][B ][B ][  ]
[  ][B ][  ][Hr][  ][  ][  ][  ][  ][  ][Wr][  ][  ][  ][  ][  ]
[  ][  ][  ][  ][  ][  ][  ][  ][  ][  ][  ][  ][  ][  ][  ][  ]
[  ][  ][  ][  ][Wr][  ][  ][  ][B ][Hd][  ][  ][  ][  ][  ][  ]
[  ][  ][  ][  ][  ][  ][  ][B ][Wl][  ][B ][  ][  ][  ][Wl][  ]
[B ][  ][  ][  ][  ][  ][  ][  ][  ][  ][  ][  ][  ][  ][B ][Wl]
[  ][  ][  ][  ][  ][  ][  ][Hl][  ][  ][B ][  ][  ][  ][  ][Ex]
