[D ][  ][  ][  ][  ][  ][  ][  ][  ][  ][  ][  ][B ][  ][B ][  ]
[  ][  ][  ][  ][  ][  ][B ][Hr][  ][  ][  ][  ][  ][  ][  ][  ]
[  ][  ][  ][  ][Hr][Hd][  ][  ][  ][  ][  ][  ][  ][  ][  ][  ]
[  ][  ][  ][  ][  ][  ][  ][  ][  ][  ][Hu][  ][B ][  ][  ][  ]
[  ][  ][  ][  ][  ][  ][  ][  ][  ][  ][  ][  ][Hd][  ][  ][  ]
[  ][  ][  ][  ][  ][  ][  ][  ][  ][  ][  ][  ][  ][  ][  ][  ]
[  ][  ][  ][  ][  ][  ][B ][  ][  ][  ][B ][  ][  ][  ][  ][  ]
[  ][  ][  ][  ][  ][  ][  ][  ][  ][  ][  ][  ][  ][  ][  ][Wl]
[  ][  ][  ][  ][  ][  ][  ][  ][  ][  ][B ][  ][  ][  ][  ][Ex]
