[D ][  ][  ][  ][  ][  ][  ][Wr][  ][  ][  ][  ][B ][Hl][B ][  ]
[  ][  ][  ][  ][  ][  ][B ][  ][  ][  ][  ][  ][  ][  ][  ][  ]
[  ][  ][  ][  ][Hr][  ][  ][Hl][  ][  ][  ][  ][B ][B ][B ][  ]
[  ][  ][  ][Hr][B ][  ][  ][  ][  ][  ][Wr][  ][  ][  ][  ][  ]
[  ][  ][  ][  ][  ][  ][  ][  ][  ][  ][  ][  ][Hd][  ][  ][  ]
[  ][  ][  ][  ][  ][  ][  ][Wr][B ][Hd][  ][  ][  ][Hr][  ][  ]
[  ][  ][  ][  ][  ][  ][  ][  ][Wl][  ][B ][  ][  ][  ][Wl][  ]
[B ][  ][  ][  ][  ][  ][  ][  ][B ][  ][  ][  ][  ][  ][B ][  ]
[  ][  ][  ][B ][Hd][B ][  ][Hl][  ][  ][B ][  ][  ][  ][  ][Ex]
