[D ][  ][  ][  ][B ][  ][  ][Hl][  ][  ][  ][  ][  ][  ][Hl][Hu]
[  ][  ][  ][  ][  ][B ][  ][  ][  ][  ][  ][Wd][  ][  ][  ][B ]
[  ][  ][  ][  ][  ][B ][B ][Hl][  ][B ][B ][  ][  ][  ][  ][  ]
[B ][  ][  ][  ][  ][  ][  ][  ][  ][  ][  ][  ][  ][  ][B ][Hr]
[  ][  ][  ][Wl][B ][  ][  ][  ][  ][  ][  ][Wu][  ][  ][  ][Wu]
[  ][  ][B ][  ][  ][  ][  ][  ][  ][  ][B ][  ][  ][  ][  ][  ]
[  ][  ][  ][  ][Wr][Wl][  ][B ][  ][  ][  ][  ][  ][Wu][  ][B ]
[Wu][Wr][  ][Wl][  ][Wr][  ][B ][  ][Hd][  ][  ][Hd][  ][  ][B ]
[  ][  ][Hl][  ][  ][  ][Wl][Hd][  ][  ][  ][  ][  ][Wr][Hl][Ex]
