[D ][  ][  ][  ][  ][  ][  ][  ][  ][  ][  ][  ][B ][  ][B ][  ]
[  ][  ][Hr][  ][  ][  ][B ][Hr][  ][  ][B ][  ][  ][  ][  ][B ]
[  ][  ][  ][  ][Hr][Hr][  ][  ][  ][  ][  ][Hl][  ][  ][  ][  ]
[  ][  ][  ][  ][  ][  ][  ][  ][  ][  ][Hu][  ][B ][  ][  ][  ]
[  ][  ][  ][  ][  ][  ][  ][  ][Wl][  ][Wr][  ][Hd][  ][  ][  ]
[  ][  ][  ][  ][  ][  ][  ][B ][  ][  ][  ][  ][Wu][  ][  ][  ]
[  ][  ][  ][  ][  ][  ][B ][  ][  ][  ][B ][  ][  ][  ][  ][  ]
[  ][  ][  ][  ][  ][B ][Wu][  ][  ][  ][  ][  ][  ][Wr][B ][Wl]
[  ][  ][  ][Wr][  ][Wr][Wr][  ][  ][  ][  ][B ][  ][  ][  ][Ex]
