[D ][  ][  ][  ][  ][  ][Wd][  ][  ][  ][Wl][  ][B ][  ][B ][  ]
[  ][  ][  ][  ][  ][  ][B ][  ][  ][  ][  ][  ][  ][  ][  ][  ]
[  ][  ][Wu][  ][Hr][  ][  ][  ][  ][  ][Wr][B ][  ][  ][  ][  ]
[  ][  ][  ][  ][  ][  ][  ][  ][  ][  ][B ][  ][  ][  ][  ][  ]
[  ][  ][B ][  ][  ][  ][  ][  ][  ][  ][  ][  ][Hr][  ][  ][  ]
[B ][  ][  ][  ][Wl][  ][  ][  ][B ][Hd][  ][B ][Hl][B ][Wd][  ]
[  ][  ][  ][  ][  ][B ][  ][  ][  ][Wd][  ][Hu][  ][  ][  ][  ]
[Hr][  ][  ][  ][Hl][  ][  ][  ][  ][B ][  ][  ][  ][  ][Wl][Wl]
[  ][  ][  ][  ][Hd][  ][  ][Wd][  ][  ][B ][  ][  ][B ][  ][Ex]
