[D ][  ][  ][  ][  ][  ][  ][  ][  ][  ][  ][Wd][  ][  ][  ][Wl]
[  ][  ][Hd][  ][  ][  ][  ][  ][  ][  ][  ][Wd][  ][  ][  ][  ]
[  ][  ][Wr][  ][Hr][  ][  ][  ][  ][B ][  ][  ][  ][  ][  ][  ]
[Hl][  ][  ][  ][B ][  ][Wd][  ][  ][  ][Wr][Hu][  ][  ][  ][  ]
[  ][  ][  ][  ][Hl][  ][  ][  ][  ][  ][B ][  ][B ][  ][  ][  ]
[  ][  ][B ][  ][  ][  ][  ][  ][B ][  ][  ][  ][  ][B ][  ][  ]
[  ][  ][  ][  ][  ][  ][  ][B ][Hu][  ][B ][  ][  ][  ][  ][  ]
[  ][  ][  ][  ][  ][  ][  ][B ][  ][  ][  ][  ][  ][Wu][  ][  ]
[  ][  ][Hd][B ][Hd][  ][  ][Hd][  ][  ][  ][  ][  ][  ][Wd][Ex]
