[D ][  ][  ][  ][  ][  ][  ][  ][  ][  ][  ][Wd][  ][  ][  ][Wl]
[  ][  ][Hd][  ][  ][  ][Hd][  ][  ][  ][  ][Wd][  ][  ][  ][  ]
[  ][  ][Wr][  ][Hr][  ][  ][  ][  ][B ][  ][  ][  ][  ][  ][  ]
[Hl][  ][  ][  ][  ][  ][Wd][  ][  ][  ][Wr][Hu][  ][  ][  ][  ]
[  ][  ][  ][  ][Hl][  ][  ][  ][  ][  ][B ][  ][B ][  ][  ][  ]
[  ][  ][  ][  ][  ][  ][  ][  ][B ][  ][  ][  ][  ][  ][  ][  ]
[  ][Wu][  ][  ][  ][  ][  ][B ][Hu][  ][B ][  ][  ][  ][  ][  ]
[  ][  ][  ][  ][  ][  ][  ][B ][B ][  ][  ][  ][  ][Wu][  ][  ]
[  ][  ][Hd][B ][Hd][  ][  ][  ][  ][  ][  ][  ][  ][  ][Wd][Ex]
