[D ][  ][  ][  ][  ][  ][  ][Wr][B ][  ][  ][  ][B ][  ][B ][  ]
[  ][  ][  ][  ][  ][  ][  ][  ][  ][  ][  ][Wd][  ][  ][  ][  ]
[  ][  ][  ][  ][Hr][  ][  ][  ][  ][  ][  ][  ][  ][  ][B ][  ]
[  ][B ][  ][  ][  ][  ][  ][  ][  ][  ][  ][  ][  ][  ][  ][  ]
[  ][  ][  ][  ][  ][  ][  ][  ][  ][  ][  ][  ][Hd][  ][  ][  ]
[  ][  ][  ][  ][  ][  ][  ][  ][B ][  ][  ][  ][  ][Hr][  ][  ]
[  ][  ][  ][  ][  ][  ][  ][  ][Wl][  ][B ][  ][Wd][  ][Wl][  ]
[Wu][  ][  ][  ][  ][  ][  ][  ][Hl][  ][  ][  ][  ][  ][  ][Wl]
[  ][  ][  ][B ][Hd][  ][  ][Hd][  ][  ][Wr][  ][  ][  ][  ][Ex]
