[D ][  ][  ][  ][B ][  ][Hd][Hl][  ][  ][  ][  ][  ][  ][Hl][Wl]
[  ][  ][  ][  ][  ][B ][  ][  ][  ][  ][  ][Wd][  ][  ][  ][B ]
[  ][  ][  ][  ][  ][B ][B ][Hl][  ][B ][B ][  ][  ][  ][  ][  ]
[B ][  ][  ][  ][  ][  ][  ][  ][  ][  ][  ][  ][  ][  ][B ][Hr]
[  ][  ][  ][Wl][B ][  ][  ][  ][  ][  ][  ][Wu][  ][  ][  ][  ]
[  ][  ][B ][  ][B ][  ][  ][  ][  ][  ][B ][  ][  ][  ][  ][  ]
[  ][  ][  ][  ][Wr][  ][  ][B ][  ][  ][  ][  ][  ][Wu][  ][B ]
[Wu][Wr][  ][Wl][  ][Wr][  ][B ][  ][Hd][  ][  ][Hd][  ][  ][  ]
[  ][  ][Hl][  ][  ][  ][Wl][Hd][  ][  ][  ][  ][  ][Wr][Hl][Ex]
