[D ][B ][  ][  ][  ][  ][  ][  ][  ][  ][Hd][  ][  ][  ][  ][Wl]
[  ][  ][  ][  ][  ][  ][  ][  ][Wl][  ][  ][Wd][  ][  ][  ][B ]
[  ][  ][  ][  ][Hr][  ][  ][  ][  ][B ][B ][  ][  ][  ][  ][  ]
[  ][  ][  ][  ][  ][  ][Wd][  ][  ][  ][  ][Hu][  ][  ][  ][  ]
[  ][  ][  ][  ][  ][  ][  ][  ][  ][Hr][B ][  ][B ][  ][  ][Wu]
[  ][  ][  ][  ][  ][  ][  ][  ][  ][  ][  ][  ][  ][  ][  ][  ]
[  ][  ][  ][  ][  ][  ][  ][B ][  ][  ][B ][  ][  ][  ][  ][  ]
[Wu][  ][  ][  ][  ][  ][  ][B ][  ][  ][  ][  ][  ][  ][  ][  ]
[  ][  ][Hd][  ][Hd][  ][  ][  ][  ][  ][  ][  ][  ][  ][  ][Ex]
