[D ][  ][  ][  ][  ][  ][  ][Wr][  ][  ][Wr][  ][B ][  ][B ][  ]
[  ][  ][Hu][  ][  ][  ][  ][  ][  ][  ][  ][Wd][  ][  ][  ][  ]
[  ][  ][  ][  ][Hr][  ][  ][Hl][Wd][  ][  ][  ][  ][  ][B ][  ]
[  ][  ][  ][  ][  ][  ][  ][  ][  ][  ][Wr][  ][  ][  ][  ][  ]
[  ][  ][  ][  ][  ][  ][  ][  ][  ][  ][  ][  ][Hd][  ][  ][  ]
[  ][  ][  ][  ][  ][  ][  ][  ][B ][  ][  ][  ][  ][Hr][  ][  ]
[  ][Wr][  ][  ][  ][Hr][  ][B ][Wl][  ][B ][  ][  ][  ][  ][  ]
[Wu][  ][  ][  ][  ][  ][  ][Wd][  ][  ][  ][  ][  ][  ][B ][  ]
[  ][  ][  ][B ][Hd][B ][  ][  ][  ][  ][B ][  ][  ][  ][  ][Ex]
