[D ][  ][  ][  ][  ][  ][  ][  ][  ][Hu][  ][  ][B ][  ][  ][  ]
[  ][  ][  ][  ][  ][  ][B ][  ][  ][  ][  ][  ][  ][  ][  ][  ]
[  ][  ][Wu][  ][Hr][Wd][  ][  ][  ][  ][  ][  ][B ][B ][B ][  ]
[  ][B ][  ][Hr][  ][  ][  ][  ][  ][  ][Wr][  ][  ][  ][  ][  ]
[  ][  ][  ][  ][  ][  ][  ][  ][  ][Hr][  ][  ][  ][  ][  ][  ]
[  ][  ][  ][  ][Wr][  ][  ][  ][B ][B ][  ][  ][  ][  ][  ][  ]
[  ][  ][  ][  ][  ][  ][  ][B ][Wl][  ][  ][  ][  ][  ][  ][B ]
[  ][  ][  ][  ][  ][  ][  ][  ][  ][  ][  ][  ][  ][  ][B ][Hl]
[  ][  ][  ][  ][  ][  ][  ][Hl][  ][  ][B ][  ][  ][  ][  ][Ex]
