[D ][  ][  ][  ][  ][  ][  ][Wr][B ][  ][  ][  ][B ][  ][B ][  ]
[  ][  ][  ][  ][  ][  ][  ][  ][  ][  ][  ][Wd][  ][  ][  ][  ]
[  ][  ][  ][  ][Hr][  ][  ][  ][  ][  ][  ][  ][  ][  ][B ][  ]
[  ][B ][  ][  ][  ][  ][  ][  ][  ][  ][  ][  ][  ][  ][  ][  ]
[  ][  ][  ][  ][  ][  ][  ][  ][  ][  ][  ][  ][Hd][  ][  ][  ]
[  ][  ][  ][  ][  ][  ][  ][  ][B ][  ][  ][  ][  ][Hr][  ][  ]
[  ][  ][  ][  ][  ][  ][  ][B ][Wl][  ][B ][  ][  ][  ][Wl][  ]
[Wu][  ][  ][  ][  ][  ][  ][  ][Hl][  ][  ][  ][  ][  ][  ][Wl]
[  ][  ][  ][B ][Hd][B ][  ][Hd][  ][  ][  ][  ][  ][  ][  ][Ex]
