[D ][  ][  ][  ][  ][  ][  ][  ][  ][  ][  ][Wd][  ][  ][  ][Wl]
[  ][  ][Hd][  ][  ][  ][  ][  ][  ][  ][  ][Wd][  ][  ][  ][  ]
[  ][  ][  ][  ][Hr][  ][  ][  ][  ][B ][  ][  ][  ][  ][  ][  ]
[Hl][  ][  ][  ][  ][  ][Wd][  ][  ][  ][Wr][Hu][  ][  ][  ][  ]
[  ][  ][  ][  ][Hl][  ][  ][  ][  ][Hr][B ][  ][B ][  ][  ][Wu]
[  ][  ][  ][  ][  ][  ][  ][  ][B ][  ][B ][  ][  ][B ][  ][Wr]
[  ][  ][  ][  ][  ][  ][  ][B ][Hu][  ][B ][  ][  ][  ][Hu][  ]
[  ][Wr][  ][  ][  ][  ][  ][B ][B ][  ][  ][  ][  ][Wu][  ][  ]
[  ][Hl][Hd][B ][  ][  ][  ][Hd][  ][  ][  ][  ][  ][  ][Wd][Ex]
