[D ][  ][  ][  ][  ][  ][Hd][Hl][  ][  ][  ][  ][  ][  ][Hl][Wl]
[  ][  ][  ][  ][  ][  ][  ][  ][Wl][  ][  ][Wd][  ][  ][  ][B ]
[  ][  ][B ][  ][  ][Hr][  ][  ][  ][B ][B ][  ][  ][  ][  ][  ]
[  ][  ][  ][  ][  ][  ][  ][  ][  ][  ][  ][Hu][B ][  ][B ][Hr]
[  ][B ][  ][  ][B ][  ][  ][  ][  ][  ][  ][Wu][B ][  ][  ][Wu]
[  ][  ][B ][  ][  ][  ][  ][  ][  ][  ][B ][  ][  ][  ][  ][  ]
[  ][  ][  ][  ][Wr][  ][  ][B ][  ][  ][  ][  ][  ][Wu][  ][  ]
[Wu][Wr][  ][  ][  ][Hl][  ][B ][  ][  ][  ][  ][B ][  ][  ][  ]
[  ][  ][Hl][B ][  ][Hl][Wl][  ][  ][  ][  ][  ][  ][  ][Hl][Ex]
