[  ][Ex][  ][B ][  ][Wl][Hr][  ][  ][Hr][  ][B ][Wd][  ][  ][  ]
[  ][  ][  ][  ][  ][  ][B ][Hl][Hd][  ][Hr][D ][Hd][  ][B ][  ]
[  ][  ][  ][  ][  ][  ][Wl][  ][  ][Wr][  ][  ][  ][B ][  ][  ]
[  ][  ][  ][  ][  ][  ][  ][  ][  ][  ][Hu][  ][  ][  ][  ][  ]
[B ][Wu][  ][  ][  ][  ][B ][Hr][  ][  ][  ][Wd][  ][Hu][B ][  ]
[  ][  ][  ][  ][  ][  ][  ][Hl][  ][  ][Wl][  ][  ][  ][  ][  ]
[  ][  ][Hr][Hl][Hl][  ][  ][Hu][  ][  ][  ][  ][  ][  ][  ][Hu]
[  ][  ][  ][  ][  ][  ][  ][  ][B ][  ][  ][Wl][Wd][  ][  ][Hl]
[  ][  ][  ][  ][  ][B ][  ][Wd][  ][  ][B ][Wd][  ][  ][  ][  ]
