[  ][Ex][  ][  ][B ][  ][  ][  ][  ][  ][Wd][  ][  ][  ][  ][  ]
[  ][  ][  ][  ][  ][  ][  ][  ][  ][  ][Wr][D ][  ][Wd][Hr][Hd]
[  ][  ][  ][  ][Hr][  ][  ][  ][  ][  ][  ][  ][Wd][  ][Hl][  ]
[  ][  ][  ][  ][  ][  ][  ][  ][  ][  ][  ][  ][  ][B ][  ][  ]
[  ][  ][  ][B ][  ][  ][  ][  ][  ][Wu][  ][  ][  ][  ][  ][  ]
[  ][  ][  ][  ][  ][  ][  ][  ][  ][  ][  ][  ][  ][  ][  ][  ]
[  ][  ][Hd][Hr][  ][  ][  ][  ][  ][  ][  ][  ][B ][  ][  ][  ]
[  ][  ][  ][  ][  ][Wd][  ][  ][  ][  ][B ][  ][  ][  ][Wr][  ]
[  ][  ][  ][  ][  ][Hd][  ][B ][Wd][  ][  ][  ][  ][Hd][  ][  ]
