[  ][Ex][  ][  ][  ][  ][  ][  ][B ][  ][  ][  ][Wd][B ][  ][  ]
[  ][  ][Hl][  ][  ][  ][B ][B ][Hu][  ][  ][D ][  ][  ][  ][Hl]
[  ][  ][  ][  ][  ][  ][  ][  ][  ][  ][  ][  ][  ][B ][  ][Wl]
[  ][  ][  ][Wd][  ][  ][  ][  ][  ][  ][  ][  ][  ][  ][  ][  ]
[  ][  ][  ][  ][  ][  ][B ][Hd][Wu][  ][  ][  ][  ][  ][  ][  ]
[  ][  ][  ][Wr][  ][Wl][Wl][B ][  ][  ][B ][  ][  ][  ][  ][  ]
[Hu][  ][  ][Hl][B ][  ][  ][  ][  ][  ][  ][B ][Wd][  ][  ][Wu]
[  ][  ][  ][  ][  ][  ][Wu][  ][  ][  ][  ][  ][  ][  ][  ][  ]
[  ][Wl][  ][  ][  ][B ][  ][Wd][  ][  ][B ][Wd][Wu][  ][  ][  ]
