[  ][Ex][  ][B ][  ][Wl][Hr][  ][B ][Hr][  ][B ][B ][  ][  ][  ]
[  ][  ][  ][  ][  ][  ][B ][B ][Hd][  ][Hr][D ][Hr][  ][B ][  ]
[  ][  ][  ][  ][  ][  ][Wl][  ][  ][Wr][  ][  ][  ][B ][  ][  ]
[  ][Wu][  ][  ][  ][  ][  ][Hr][  ][B ][Hu][  ][  ][  ][  ][  ]
[B ][Wu][  ][  ][  ][  ][B ][Hr][  ][  ][B ][Wd][  ][Hu][B ][  ]
[  ][  ][  ][  ][  ][B ][Wl][Hl][  ][  ][Wl][  ][  ][  ][  ][  ]
[  ][  ][Hr][Hl][Hl][Hr][  ][Hu][  ][  ][  ][  ][Wr][  ][  ][Hu]
[  ][  ][  ][  ][  ][  ][  ][  ][B ][  ][  ][Wl][Wd][  ][  ][Hl]
[  ][  ][  ][  ][  ][B ][  ][Wd][  ][  ][  ][Wd][Wu][  ][  ][  ]
