[  ][Ex][Hr][  ][  ][  ][  ][  ][  ][  ][  ][  ][  ][  ][  ][Hl]
[  ][Wu][Hl][  ][  ][  ][  ][  ][  ][  ][  ][D ][B ][  ][  ][  ]
[  ][  ][  ][  ][  ][  ][B ][  ][  ][  ][  ][  ][  ][  ][  ][Wu]
[  ][  ][  ][  ][  ][  ][  ][  ][  ][B ][  ][Wl][  ][  ][  ][  ]
[  ][B ][  ][  ][  ][  ][  ][Hd][  ][  ][B ][B ][  ][  ][  ][  ]
[  ][  ][  ][  ][  ][B ][B ][  ][  ][  ][B ][  ][  ][  ][  ][  ]
[  ][  ][  ][Hl][  ][  ][  ][  ][  ][  ][B ][  ][Wd][B ][  ][B ]
[  ][  ][  ][  ][  ][  ][Wu][  ][  ][  ][  ][  ][  ][Wl][  ][  ]
[  ][  ][  ][  ][  ][  ][  ][  ][  ][  ][B ][Wd][  ][  ][Wl][  ]
