[  ][Ex][  ][  ][B ][  ][  ][  ][  ][  ][  ][B ][  ][  ][  ][Hl]
[  ][  ][B ][  ][  ][  ][  ][  ][  ][  ][  ][D ][  ][Wr][B ][  ]
[  ][  ][  ][  ][  ][  ][  ][  ][  ][  ][  ][  ][  ][  ][  ][  ]
[  ][  ][  ][  ][Hu][  ][Wl][  ][B ][  ][  ][Wl][  ][B ][  ][  ]
[  ][  ][  ][  ][Wu][  ][  ][Hd][  ][  ][  ][B ][  ][  ][  ][  ]
[Hl][  ][Hr][  ][  ][  ][B ][  ][  ][  ][  ][Wr][B ][Wl][  ][Hr]
[  ][  ][Hd][  ][Wl][  ][  ][  ][Hr][  ][Wr][  ][Wd][  ][  ][B ]
[  ][  ][  ][  ][  ][Wd][  ][  ][  ][  ][  ][  ][  ][  ][  ][  ]
[  ][B ][Hu][  ][  ][  ][  ][  ][Hr][  ][B ][  ][  ][  ][Wl][  ]
