[  ][Ex][  ][  ][  ][  ][  ][  ][  ][  ][  ][  ][  ][  ][  ][Hl]
[  ][Wu][Hl][  ][  ][  ][  ][  ][  ][B ][Wr][D ][B ][  ][  ][  ]
[  ][  ][  ][Hl][  ][  ][B ][  ][  ][  ][  ][  ][  ][  ][  ][  ]
[  ][  ][  ][  ][  ][  ][  ][  ][  ][B ][  ][Wl][Hl][  ][  ][  ]
[  ][  ][  ][  ][  ][  ][  ][Hd][  ][  ][  ][B ][  ][  ][  ][  ]
[Hl][  ][  ][  ][  ][B ][  ][  ][  ][  ][B ][  ][B ][Wl][  ][Hr]
[  ][  ][  ][Hl][Wl][  ][  ][B ][Hr][  ][  ][  ][Wd][B ][  ][B ]
[  ][  ][  ][  ][Hu][  ][Wd][  ][  ][B ][  ][Wu][  ][Wl][  ][  ]
[  ][  ][  ][Wd][B ][  ][  ][B ][Hr][  ][B ][Wd][  ][  ][Wl][  ]
