[  ][Ex][  ][  ][  ][  ][  ][  ][  ][  ][  ][  ][  ][  ][  ][  ]
[  ][Wu][Hu][B ][  ][  ][  ][  ][  ][B ][Wr][D ][B ][Wr][  ][  ]
[  ][  ][  ][Hl][  ][  ][B ][  ][  ][  ][  ][  ][  ][  ][  ][  ]
[  ][  ][  ][  ][  ][  ][  ][  ][  ][B ][  ][Wl][Hl][  ][  ][  ]
[  ][  ][  ][  ][  ][  ][  ][Hd][  ][  ][  ][B ][Hu][  ][  ][  ]
[Hl][  ][  ][  ][  ][  ][  ][  ][  ][  ][B ][  ][B ][Wl][  ][Hr]
[  ][  ][Hd][  ][  ][  ][  ][B ][Hr][  ][  ][  ][Wd][B ][  ][B ]
[  ][  ][  ][  ][Hl][  ][Wd][  ][  ][B ][  ][Wu][  ][  ][  ][  ]
[Hr][  ][  ][Wd][B ][Wu][  ][B ][Hr][  ][  ][Wd][  ][  ][Wl][  ]
