[  ][Ex][  ][  ][  ][B ][  ][  ][  ][  ][Hl][Hl][  ][  ][Hr][  ]
[  ][Wd][  ][  ][  ][  ][  ][Wu][  ][Wu][Wr][D ][  ][Wd][  ][  ]
[Hl][  ][  ][  ][  ][  ][  ][  ][  ][  ][  ][  ][Hr][  ][  ][  ]
[  ][  ][  ][  ][Hr][  ][Wr][  ][Wu][  ][  ][  ][B ][  ][  ][  ]
[  ][  ][  ][Wl][  ][Wl][  ][  ][  ][  ][  ][  ][  ][Hr][  ][  ]
[  ][  ][  ][  ][  ][  ][  ][Wr][  ][  ][  ][  ][  ][Hu][  ][Hl]
[  ][  ][  ][Hr][  ][  ][  ][  ][  ][  ][  ][B ][  ][  ][  ][  ]
[  ][  ][B ][  ][Hu][Wd][  ][  ][  ][  ][  ][  ][  ][  ][  ][Wl]
[  ][  ][  ][  ][  ][Hd][  ][  ][  ][  ][  ][  ][B ][  ][  ][  ]
