[  ][Ex][  ][  ][B ][B ][  ][  ][  ][  ][  ][  ][Wl][  ][  ][Hl]
[  ][  ][  ][  ][Wr][  ][  ][Wu][  ][B ][  ][D ][  ][Wd][  ][  ]
[  ][  ][  ][  ][  ][  ][Hu][  ][  ][Hd][B ][  ][B ][  ][  ][  ]
[  ][  ][  ][  ][  ][  ][  ][  ][  ][  ][  ][Wl][B ][B ][  ][  ]
[  ][  ][  ][  ][  ][  ][  ][  ][  ][  ][  ][B ][  ][B ][  ][  ]
[Hl][  ][  ][  ][  ][  ][  ][  ][  ][  ][  ][  ][Hu][  ][  ][  ]
[  ][  ][  ][Hr][  ][  ][  ][  ][  ][  ][  ][  ][  ][  ][  ][  ]
[  ][  ][  ][  ][  ][Wd][  ][  ][  ][  ][  ][  ][  ][  ][  ][  ]
[  ][  ][  ][  ][  ][Hd][  ][  ][Wd][  ][  ][  ][  ][  ][  ][  ]
