[  ][Ex][  ][  ][B ][  ][  ][  ][  ][  ][  ][B ][Wl][  ][  ][Hl]
[  ][  ][B ][  ][  ][  ][  ][  ][  ][B ][Wr][D ][  ][Wd][  ][  ]
[  ][  ][  ][  ][  ][  ][  ][  ][  ][  ][  ][  ][  ][  ][Hd][B ]
[  ][  ][  ][  ][  ][  ][  ][  ][B ][  ][  ][Wl][B ][B ][  ][  ]
[  ][  ][  ][  ][Hr][  ][  ][Hd][  ][  ][  ][B ][  ][B ][Wu][  ]
[Hl][  ][  ][  ][B ][Hu][B ][  ][  ][  ][  ][  ][Hu][  ][  ][  ]
[  ][  ][Hd][  ][Wl][  ][  ][  ][Hr][  ][Wr][  ][  ][Wd][Hu][B ]
[Hd][  ][  ][  ][  ][Wd][  ][  ][  ][  ][  ][  ][  ][  ][  ][  ]
[  ][B ][Hu][  ][  ][  ][  ][  ][Wd][  ][B ][  ][  ][  ][  ][  ]
