[  ][Ex][  ][  ][  ][  ][  ][  ][  ][  ][  ][  ][  ][  ][  ][Hl]
[  ][Wu][  ][  ][  ][  ][  ][  ][  ][B ][Wr][D ][  ][Wr][  ][  ]
[  ][  ][  ][  ][  ][  ][  ][  ][  ][  ][  ][  ][  ][  ][  ][  ]
[  ][  ][  ][  ][  ][  ][  ][  ][  ][  ][  ][Wl][Hl][  ][  ][  ]
[  ][  ][  ][  ][  ][  ][  ][Hd][  ][  ][  ][B ][Hu][  ][  ][  ]
[Hl][  ][  ][  ][  ][  ][B ][  ][  ][  ][  ][  ][B ][Wl][  ][Hr]
[  ][  ][Hd][  ][Wl][  ][  ][  ][Hr][  ][  ][  ][Wd][  ][  ][B ]
[  ][  ][  ][  ][  ][Wd][  ][  ][  ][  ][  ][Wu][  ][Wl][  ][  ]
[  ][  ][  ][  ][  ][Wu][  ][  ][Hr][  ][B ][  ][  ][  ][Wl][  ]
