[  ][Ex][  ][  ][B ][B ][  ][  ][  ][  ][  ][  ][Wl][  ][  ][Hl]
[  ][  ][  ][  ][Wr][  ][  ][Wu][  ][B ][Wr][D ][  ][Wd][  ][  ]
[  ][  ][  ][  ][  ][  ][  ][  ][  ][  ][B ][  ][  ][  ][  ][  ]
[  ][  ][  ][  ][  ][  ][  ][  ][  ][  ][  ][Wl][  ][B ][  ][  ]
[  ][  ][  ][  ][  ][Wl][  ][  ][  ][  ][  ][  ][  ][B ][  ][  ]
[Hl][  ][  ][  ][  ][  ][  ][  ][Wd][  ][  ][  ][Hu][  ][  ][  ]
[  ][  ][  ][  ][  ][  ][  ][  ][Hr][  ][  ][  ][  ][  ][  ][  ]
[  ][  ][  ][  ][  ][Wd][  ][  ][  ][  ][  ][  ][  ][  ][  ][  ]
[  ][  ][B ][  ][  ][Hd][  ][  ][Wd][  ][  ][  ][  ][B ][  ][  ]
