[  ][Ex][  ][  ][B ][B ][  ][  ][  ][  ][  ][Hu][Wl][  ][Wd][Wd]
[Hd][  ][  ][  ][  ][  ][B ][Wu][  ][Wl][  ][D ][B ][Wd][  ][  ]
[  ][  ][  ][  ][  ][Wr][Hu][  ][  ][  ][  ][  ][B ][  ][  ][  ]
[  ][  ][  ][  ][  ][Hu][  ][  ][  ][  ][  ][Wl][B ][B ][  ][  ]
[  ][  ][  ][  ][  ][  ][  ][  ][  ][  ][  ][B ][  ][B ][  ][  ]
[  ][  ][  ][  ][  ][  ][  ][  ][  ][  ][B ][  ][Hu][Hr][  ][Wu]
[  ][  ][  ][Hr][  ][  ][  ][  ][  ][  ][B ][Hu][  ][  ][  ][Hl]
[  ][  ][  ][  ][  ][B ][  ][  ][  ][  ][  ][  ][  ][  ][  ][  ]
[  ][Hr][  ][  ][  ][  ][  ][  ][Wd][B ][  ][  ][  ][  ][  ][  ]
