[  ][Ex][  ][  ][B ][  ][  ][  ][  ][  ][  ][  ][B ][  ][Wd][Hl]
[  ][  ][B ][  ][  ][  ][  ][  ][  ][B ][Wr][D ][Hr][Wd][  ][  ]
[  ][  ][  ][  ][  ][  ][B ][  ][  ][  ][  ][  ][  ][  ][Hu][  ]
[Wl][  ][  ][  ][B ][Hr][  ][  ][  ][  ][  ][Wl][Hl][B ][  ][Hu]
[  ][  ][  ][  ][  ][Wu][Hd][  ][  ][  ][B ][B ][  ][B ][Wu][  ]
[Hl][  ][  ][  ][B ][Hu][  ][  ][  ][  ][  ][  ][Hu][  ][  ][  ]
[B ][  ][  ][  ][  ][  ][  ][  ][Hr][  ][Wr][  ][  ][  ][  ][  ]
[  ][  ][  ][  ][  ][Wd][  ][  ][  ][  ][  ][  ][Hl][Hl][  ][  ]
[  ][  ][B ][  ][  ][Hd][  ][  ][Wd][  ][  ][  ][  ][  ][  ][  ]
