[  ][Ex][  ][B ][  ][  ][Hr][  ][B ][  ][  ][  ][Wd][  ][  ][  ]
[  ][  ][  ][  ][  ][  ][B ][B ][  ][  ][  ][D ][Hd][  ][B ][  ]
[  ][  ][  ][  ][  ][  ][Hd][  ][  ][  ][  ][  ][  ][B ][  ][  ]
[  ][  ][  ][Wd][  ][  ][  ][  ][  ][  ][  ][  ][  ][  ][  ][  ]
[B ][  ][  ][  ][  ][  ][B ][Hr][  ][  ][Hr][  ][  ][Hu][  ][  ]
[  ][  ][  ][  ][  ][Wr][  ][  ][  ][  ][B ][  ][  ][  ][  ][  ]
[  ][  ][Hr][Hl][Hl][  ][  ][Hu][  ][  ][  ][B ][  ][  ][  ][Hu]
[  ][  ][  ][  ][  ][  ][  ][  ][B ][  ][  ][  ][Wd][  ][  ][Hl]
[  ][Wl][  ][  ][  ][B ][  ][Wd][  ][  ][B ][Wd][  ][  ][  ][  ]
