[  ][Ex][  ][  ][B ][B ][  ][  ][  ][  ][  ][B ][Wl][  ][  ][Hl]
[  ][  ][  ][  ][Wr][  ][  ][  ][  ][B ][Wr][D ][  ][Wd][  ][  ]
[  ][  ][  ][  ][  ][  ][  ][  ][  ][  ][B ][  ][Hd][  ][  ][  ]
[  ][  ][  ][  ][  ][  ][  ][  ][  ][  ][  ][Wl][B ][B ][B ][  ]
[  ][  ][  ][  ][  ][  ][  ][  ][  ][Hd][  ][Wu][  ][B ][  ][  ]
[Hl][  ][Hl][  ][  ][  ][  ][Hr][Hu][  ][  ][  ][Hu][Hl][  ][  ]
[  ][  ][  ][  ][  ][  ][  ][  ][Hr][  ][  ][  ][  ][  ][  ][  ]
[  ][  ][  ][B ][  ][Wd][  ][  ][  ][  ][  ][  ][  ][Hu][  ][  ]
[  ][  ][B ][  ][  ][Hd][Wr][  ][Wd][  ][  ][B ][  ][B ][  ][  ]
