[  ][Ex][  ][  ][  ][  ][  ][  ][B ][  ][  ][  ][Wd][B ][  ][  ]
[  ][  ][  ][  ][  ][  ][B ][B ][  ][  ][  ][D ][  ][  ][  ][Hl]
[  ][  ][  ][  ][  ][  ][  ][  ][  ][  ][  ][  ][  ][B ][  ][Wl]
[  ][Wu][  ][B ][  ][  ][  ][  ][  ][  ][  ][  ][  ][  ][  ][  ]
[  ][  ][  ][  ][  ][  ][B ][Hd][Wu][  ][  ][  ][  ][Wd][  ][  ]
[  ][Wr][  ][Wr][  ][  ][Wl][B ][  ][  ][  ][  ][  ][  ][  ][  ]
[Hu][  ][  ][Hl][B ][  ][  ][  ][  ][  ][  ][B ][Wd][  ][  ][Wu]
[  ][  ][Hd][  ][  ][  ][Wu][  ][  ][  ][  ][  ][  ][  ][  ][  ]
[  ][Wl][  ][  ][  ][  ][  ][Wd][  ][  ][B ][Wd][Wu][  ][  ][  ]
