[  ][Ex][  ][  ][  ][  ][  ][  ][  ][  ][Hl][  ][Wl][  ][  ][  ]
[  ][  ][  ][  ][  ][  ][  ][Wu][  ][  ][  ][D ][  ][Wd][  ][  ]
[Hl][  ][  ][  ][  ][  ][B ][  ][Wl][  ][Hr][  ][  ][  ][  ][  ]
[  ][  ][  ][  ][Hr][  ][  ][  ][  ][  ][  ][  ][  ][  ][  ][  ]
[  ][  ][  ][Wl][  ][  ][  ][B ][Hu][  ][  ][  ][  ][  ][  ][  ]
[  ][  ][Hl][  ][  ][  ][  ][Wr][  ][  ][  ][  ][  ][  ][B ][B ]
[  ][  ][  ][  ][  ][  ][  ][  ][  ][  ][  ][  ][  ][B ][  ][  ]
[  ][  ][  ][  ][  ][  ][  ][  ][  ][  ][  ][  ][  ][  ][  ][Wl]
[  ][  ][  ][  ][  ][Wu][  ][  ][  ][  ][  ][  ][  ][  ][  ][  ]
