[  ][Ex][Hr][  ][B ][  ][  ][  ][  ][  ][B ][  ][Hu][  ][  ][Hl]
[  ][  ][  ][  ][  ][  ][  ][  ][  ][  ][B ][D ][  ][B ][  ][  ]
[  ][  ][Hl][  ][  ][  ][B ][B ][  ][  ][  ][  ][  ][  ][  ][Wu]
[  ][  ][Wl][  ][B ][  ][  ][Hr][  ][B ][  ][Wl][  ][Hl][Hu][  ]
[  ][  ][  ][  ][B ][Hl][Hd][  ][  ][  ][B ][B ][  ][  ][Wu][  ]
[  ][  ][  ][  ][  ][B ][B ][  ][  ][  ][B ][  ][  ][  ][  ][Wu]
[  ][B ][  ][Hl][  ][  ][  ][  ][  ][  ][B ][  ][Wd][B ][  ][Wl]
[B ][Wl][  ][  ][  ][Wd][Wu][  ][  ][  ][  ][  ][Wu][  ][  ][  ]
[Hu][Wl][  ][  ][Hl][Hu][  ][  ][  ][  ][B ][Hl][  ][  ][Wl][  ]
