[B ][Ex][  ][  ][B ][  ][  ][  ][  ][  ][Wd][  ][  ][  ][  ][  ]
[  ][  ][  ][  ][  ][  ][  ][  ][  ][  ][Wr][D ][  ][Wd][Hr][  ]
[  ][  ][  ][  ][Hr][  ][  ][  ][  ][  ][  ][  ][Wd][  ][Hl][  ]
[  ][  ][  ][  ][  ][  ][  ][  ][  ][  ][  ][  ][  ][B ][  ][  ]
[  ][  ][  ][B ][  ][  ][  ][  ][  ][Wu][  ][  ][  ][B ][  ][  ]
[  ][  ][  ][  ][  ][  ][  ][  ][  ][  ][  ][  ][  ][  ][  ][  ]
[  ][  ][Hd][Hr][  ][  ][  ][  ][  ][  ][  ][  ][B ][  ][  ][  ]
[  ][  ][  ][  ][  ][Wd][  ][  ][  ][  ][B ][  ][  ][  ][Wr][  ]
[  ][  ][  ][  ][  ][Hd][  ][B ][Wd][  ][  ][  ][  ][  ][  ][  ]
