[  ][Ex][  ][  ][  ][Wl][Wl][  ][B ][  ][  ][  ][  ][  ][  ][  ]
[  ][  ][  ][B ][  ][  ][  ][  ][Hd][  ][  ][D ][Hd][B ][  ][  ]
[  ][Wl][  ][  ][Hu][  ][Wl][  ][  ][Wr][  ][  ][  ][B ][  ][  ]
[  ][  ][  ][Wd][  ][  ][  ][  ][  ][  ][  ][  ][  ][  ][  ][  ]
[B ][Wu][  ][  ][  ][  ][B ][Hr][  ][  ][Hr][  ][  ][Hu][  ][  ]
[  ][  ][  ][  ][  ][Wr][B ][  ][Wr][  ][Wl][  ][  ][B ][  ][  ]
[B ][  ][Hr][Hl][Hl][B ][  ][  ][  ][  ][  ][B ][  ][  ][  ][  ]
[  ][  ][B ][  ][B ][  ][  ][  ][  ][  ][  ][Wl][Wd][  ][  ][  ]
[  ][  ][Hr][  ][  ][  ][  ][Wd][  ][  ][B ][B ][  ][B ][  ][  ]
