[  ][Ex][  ][  ][  ][  ][  ][  ][  ][  ][Hl][  ][  ][  ][  ][  ]
[  ][  ][  ][  ][  ][  ][  ][Wu][  ][  ][  ][D ][  ][Wd][  ][  ]
[Hl][  ][  ][  ][  ][  ][  ][  ][  ][  ][B ][  ][  ][  ][  ][  ]
[  ][B ][  ][  ][Hr][  ][  ][  ][  ][  ][  ][  ][  ][  ][  ][Wl]
[  ][  ][  ][Wl][  ][  ][  ][  ][Hu][  ][  ][  ][  ][  ][  ][  ]
[  ][  ][  ][  ][  ][  ][  ][Wr][  ][  ][  ][  ][  ][  ][  ][B ]
[  ][  ][  ][  ][B ][  ][  ][  ][  ][  ][  ][B ][  ][B ][  ][  ]
[  ][  ][  ][  ][Hu][Wd][  ][  ][  ][  ][  ][  ][  ][  ][  ][Wl]
[  ][  ][  ][  ][  ][Wu][  ][  ][  ][  ][  ][  ][  ][  ][  ][  ]
