[  ][Ex][  ][  ][  ][Wl][Wl][  ][B ][  ][  ][  ][  ][  ][  ][  ]
[  ][  ][  ][  ][  ][  ][B ][  ][Hd][  ][  ][D ][Hd][B ][  ][  ]
[  ][Wl][  ][  ][Hu][  ][Wl][  ][  ][Wr][  ][  ][  ][B ][  ][  ]
[  ][  ][  ][Wd][  ][  ][  ][  ][  ][  ][  ][  ][  ][  ][  ][  ]
[B ][Wu][  ][  ][  ][  ][B ][Hr][  ][  ][  ][  ][  ][Hu][B ][B ]
[  ][  ][  ][  ][  ][Wr][B ][  ][Wr][  ][Wl][  ][  ][B ][  ][  ]
[B ][  ][Hr][Hl][Hl][B ][  ][Wd][  ][  ][  ][B ][  ][  ][  ][  ]
[  ][  ][B ][  ][B ][  ][  ][  ][B ][  ][  ][Wl][Wd][  ][  ][  ]
[  ][  ][Hr][  ][  ][  ][  ][Wd][  ][  ][  ][Wd][  ][B ][  ][  ]
