[  ][Ex][  ][  ][  ][  ][  ][  ][  ][  ][  ][  ][  ][  ][  ][Hl]
[  ][  ][  ][  ][  ][  ][  ][  ][  ][B ][Wr][D ][  ][  ][  ][  ]
[  ][  ][  ][  ][  ][  ][  ][Wd][  ][  ][  ][  ][  ][  ][  ][  ]
[  ][  ][  ][  ][Hu][  ][  ][  ][  ][  ][  ][  ][Hl][B ][  ][  ]
[  ][  ][  ][  ][  ][  ][  ][  ][  ][  ][  ][B ][Hu][  ][  ][  ]
[Hl][  ][  ][  ][  ][  ][  ][  ][  ][  ][  ][  ][B ][Wl][  ][Hr]
[  ][  ][Hd][  ][Wl][  ][  ][  ][Hr][  ][  ][  ][Hl][  ][  ][B ]
[  ][  ][  ][  ][  ][Wd][  ][  ][  ][  ][  ][Wu][  ][Wl][  ][  ]
[  ][  ][  ][  ][  ][Hu][  ][  ][Hr][  ][Hl][  ][  ][  ][Wl][  ]
