[  ][Ex][  ][  ][  ][  ][  ][  ][  ][  ][Wd][  ][  ][  ][  ][  ]
[  ][  ][  ][  ][  ][  ][  ][Wu][  ][  ][Wr][D ][  ][  ][Hr][  ]
[Hl][  ][  ][Hr][Hr][  ][  ][  ][  ][Hd][  ][  ][  ][  ][  ][  ]
[  ][  ][  ][  ][  ][  ][  ][  ][  ][  ][  ][  ][  ][B ][  ][  ]
[  ][  ][  ][B ][  ][  ][  ][  ][  ][  ][  ][  ][  ][B ][  ][  ]
[  ][  ][  ][  ][  ][B ][  ][  ][  ][  ][  ][  ][  ][  ][  ][  ]
[  ][  ][  ][Hr][B ][  ][  ][  ][  ][  ][  ][Hu][  ][  ][  ][  ]
[  ][  ][  ][  ][B ][Wd][  ][  ][  ][  ][B ][  ][  ][  ][  ][  ]
[  ][  ][  ][  ][  ][Hd][  ][  ][Wd][  ][  ][  ][  ][  ][  ][  ]
