[  ][Ex][  ][  ][B ][  ][  ][  ][  ][  ][  ][  ][Wl][  ][  ][Hl]
[  ][  ][  ][  ][  ][  ][  ][  ][  ][B ][Wr][D ][  ][Wd][  ][  ]
[  ][  ][  ][  ][  ][  ][  ][  ][  ][  ][  ][  ][  ][  ][Hu][  ]
[  ][  ][B ][  ][  ][  ][  ][  ][  ][  ][  ][Wl][  ][B ][  ][  ]
[  ][  ][  ][  ][  ][  ][Hd][  ][  ][  ][  ][  ][  ][B ][Wu][  ]
[Hl][  ][  ][  ][B ][Hu][  ][  ][  ][  ][  ][  ][Hu][  ][  ][Hd]
[  ][  ][  ][  ][  ][  ][  ][  ][Hr][  ][Wr][  ][  ][  ][  ][  ]
[  ][  ][  ][  ][  ][Wd][  ][  ][  ][  ][  ][  ][  ][  ][  ][  ]
[  ][  ][B ][  ][  ][Hd][  ][  ][Wd][  ][  ][  ][  ][  ][  ][  ]
