[  ][Ex][Hr][  ][  ][  ][  ][  ][  ][  ][  ][  ][  ][  ][  ][Hl]
[  ][Wu][  ][  ][  ][  ][  ][  ][  ][  ][Wr][D ][B ][  ][  ][B ]
[  ][  ][  ][  ][  ][  ][B ][  ][  ][  ][  ][  ][  ][  ][  ][  ]
[  ][  ][  ][  ][  ][  ][  ][  ][  ][B ][  ][Wl][  ][  ][  ][  ]
[  ][  ][  ][  ][  ][  ][B ][  ][B ][  ][B ][B ][  ][  ][  ][  ]
[Hl][  ][  ][  ][  ][B ][B ][  ][  ][  ][B ][  ][  ][Wl][  ][  ]
[  ][  ][  ][Hl][Wl][  ][  ][B ][  ][  ][  ][  ][Wd][B ][Hu][B ]
[  ][  ][  ][  ][Hu][  ][Wd][  ][  ][  ][  ][  ][  ][Wl][  ][  ]
[  ][  ][  ][Wd][B ][  ][  ][  ][Hr][  ][B ][Wd][  ][  ][Wl][  ]
