[D ][  ][Hr][  ][Hu][  ][  ][  ]
[B ][  ][  ][  ][  ][Hu][  ][  ]
[B ][  ][  ][B ][  ][  ][  ][  ]
[B ][Wr][  ][  ][  ][Hd][  ][Wl]
[  ][  ][Wr][  ][  ][  ][  ][  ]
[  ][  ][  ][  ][B ][  ][B ][  ]
[  ][  ][Wd][Wd][  ][  ][  ][  ]
[Wl][  ][  ][  ][  ][  ][Wd][Ex]
