[D ][  ][B ][  ][  ][Hr][  ][  ]
[  ][Wu][  ][  ][  ][  ][  ][  ]
[  ][Wr][  ][  ][  ][  ][  ][Wu]
[B ][  ][  ][  ][  ][  ][B ][  ]
[B ][B ][Hr][Hd][  ][  ][  ][  ]
[  ][B ][  ][  ][  ][Wr][  ][  ]
[  ][  ][  ][Wr][Wl][Hl][  ][  ]
[  ][  ][  ][  ][Wr][  ][  ][Ex]
