[D ][  ][  ][Wd][  ][  ][  ][B ]
[Hl][  ][  ][Wl][  ][  ][Hl][  ]
[  ][  ][  ][  ][Hr][  ][B ][  ]
[B ][  ][  ][  ][B ][  ][  ][  ]
[  ][  ][  ][B ][  ][  ][Hl][Wu]
[Wd][Wd][  ][  ][  ][  ][  ][B ]
[  ][B ][  ][B ][B ][  ][  ][  ]
[  ][B ][  ][  ][  ][  ][  ][Ex]
