[D ][  ][B ][B ][  ][  ][  ][  ]
[  ][B ][Hd][  ][  ][  ][B ][  ]
[  ][  ][  ][Wl][  ][  ][  ][  ]
[  ][  ][  ][  ][Wu][B ][  ][  ]
[  ][  ][  ][  ][  ][  ][  ][B ]
[  ][  ][  ][  ][  ][  ][Wd][B ]
[  ][Wd][  ][  ][Wr][Hd][  ][  ]
[  ][  ][  ][B ][  ][  ][Wu][Ex]
