[D ][  ][Hr][  ][  ][  ][  ][  ]
[Wu][  ][  ][  ][  ][  ][  ][  ]
[  ][  ][  ][B ][  ][  ][  ][  ]
[  ][B ][  ][  ][  ][  ][  ][  ]
[  ][  ][  ][  ][  ][  ][  ][Wr]
[  ][  ][  ][  ][B ][  ][B ][  ]
[  ][Hl][  ][  ][  ][  ][  ][  ]
[  ][  ][  ][  ][Hl][  ][B ][Ex]
