[D ][  ][  ][  ][  ][Hu][  ][  ]
[  ][B ][  ][  ][Hr][Hd][  ][  ]
[  ][B ][  ][  ][  ][Hd][  ][  ]
[Hr][  ][  ][B ][  ][  ][  ][  ]
[  ][  ][  ][  ][  ][  ][  ][  ]
[  ][  ][B ][  ][Hl][  ][Wd][Wr]
[  ][  ][Wr][  ][  ][  ][  ][  ]
[  ][  ][  ][Wu][Hu][  ][  ][Ex]
