[D ][  ][B ][Wd][  ][  ][  ][B ]
[Hl][  ][  ][  ][Wd][  ][Hl][  ]
[  ][  ][  ][B ][Hu][  ][B ][Hd]
[B ][  ][  ][  ][Hl][Hl][B ][  ]
[B ][  ][Wd][B ][  ][  ][B ][B ]
[B ][  ][  ][Wr][  ][  ][  ][  ]
[  ][Hl][  ][B ][  ][  ][Wl][  ]
[B ][Hr][  ][  ][Hr][  ][  ][Ex]
