[D ][B ][  ][  ][  ][  ][  ][  ]
[  ][B ][  ][Hd][  ][  ][  ][Hl]
[  ][  ][  ][  ][B ][B ][  ][  ]
[B ][  ][  ][  ][  ][  ][  ][  ]
[  ][  ][Hr][  ][Wd][  ][  ][B ]
[  ][  ][  ][  ][Hl][  ][B ][Wr]
[  ][  ][  ][  ][  ][  ][  ][  ]
[Hl][  ][Hu][  ][Wd][  ][  ][Ex]
