[D ][  ][  ][  ][  ][  ][  ][  ]
[  ][  ][  ][  ][  ][  ][  ][  ]
[  ][  ][  ][  ][  ][  ][B ][  ]
[B ][  ][  ][  ][  ][Hr][  ][  ]
[  ][  ][  ][Wr][  ][  ][  ][B ]
[Wd][Hr][  ][  ][  ][  ][  ][B ]
[  ][  ][  ][  ][  ][  ][  ][  ]
[  ][  ][  ][  ][  ][  ][  ][Ex]
