[D ][  ][Hr][  ][  ][  ][  ][  ]
[B ][  ][  ][  ][  ][Hu][  ][  ]
[B ][  ][Wr][  ][  ][  ][  ][  ]
[  ][  ][  ][Wu][  ][Hd][  ][B ]
[  ][  ][  ][  ][Wu][  ][  ][  ]
[  ][  ][  ][  ][B ][  ][  ][Hl]
[Hu][  ][Wd][Wd][  ][  ][  ][  ]
[  ][Hr][  ][  ][  ][  ][  ][Ex]
