[D ][  ][  ][  ][  ][  ][  ][B ]
[Hr][  ][  ][  ][  ][  ][  ][  ]
[  ][  ][  ][  ][B ][  ][B ][  ]
[B ][  ][  ][  ][  ][Hr][  ][  ]
[Hl][  ][  ][Wr][  ][  ][Wu][B ]
[  ][  ][  ][  ][  ][  ][  ][B ]
[  ][B ][  ][B ][B ][  ][  ][  ]
[B ][  ][  ][  ][  ][  ][  ][Ex]
