[D ][  ][  ][Wr][  ][  ][  ][Wl]
[Hr][Wu][B ][  ][  ][B ][  ][Wr]
[Hr][  ][  ][  ][  ][Wl][  ][  ]
[  ][  ][  ][  ][  ][Hu][  ][B ]
[  ][  ][  ][  ][  ][  ][  ][  ]
[  ][  ][Wl][  ][  ][  ][  ][B ]
[  ][  ][  ][  ][Wl][  ][  ][  ]
[  ][Wd][  ][  ][Wd][  ][  ][Ex]
