[D ][  ][  ][  ][  ][Hd][Hl][  ]
[  ][  ][Hu][  ][  ][  ][  ][  ]
[B ][  ][  ][  ][  ][  ][  ][  ]
[  ][Hu][B ][  ][  ][  ][  ][  ]
[  ][  ][  ][  ][  ][  ][  ][  ]
[  ][  ][  ][  ][  ][  ][  ][Hr]
[  ][  ][  ][  ][  ][  ][  ][  ]
[  ][  ][  ][  ][  ][B ][  ][Ex]
