[D ][B ][  ][  ][  ][  ][  ][  ]
[  ][  ][  ][  ][  ][  ][  ][  ]
[  ][  ][  ][B ][  ][  ][B ][  ]
[  ][B ][B ][  ][  ][  ][  ][Hl]
[Hd][  ][  ][  ][  ][Hu][  ][Wr]
[  ][  ][  ][  ][B ][  ][B ][  ]
[  ][  ][  ][  ][  ][Wd][  ][  ]
[  ][  ][  ][  ][Hl][  ][B ][Ex]
