[D ][  ][Hd][  ][  ][  ][  ][  ]
[Hl][B ][  ][  ][  ][  ][  ][Hl]
[  ][Wl][  ][  ][B ][Wr][  ][  ]
[  ][  ][  ][  ][  ][  ][  ][  ]
[  ][Hr][Wl][  ][  ][  ][  ][B ]
[  ][  ][  ][  ][Hl][  ][B ][Wr]
[  ][  ][  ][  ][  ][  ][Hu][  ]
[Hl][  ][Hu][  ][Wd][  ][  ][Ex]
