[D ][  ][  ][Wr][  ][  ][  ][Hu]
[  ][B ][B ][  ][  ][  ][  ][Wr]
[Hr][  ][  ][  ][  ][  ][  ][  ]
[B ][  ][  ][Hu][  ][Hu][  ][B ]
[  ][  ][  ][  ][  ][  ][  ][  ]
[  ][  ][Wl][  ][  ][  ][  ][  ]
[  ][  ][  ][  ][B ][  ][  ][Wd]
[  ][  ][  ][  ][Wd][  ][  ][Ex]
