[D ][  ][B ][  ][B ][  ][  ][  ]
[Wl][  ][  ][  ][  ][  ][B ][  ]
[Wd][B ][  ][  ][Wr][Wd][  ][  ]
[Hu][  ][  ][B ][Wu][  ][Hr][  ]
[  ][  ][B ][  ][  ][  ][B ][  ]
[  ][  ][  ][Hu][  ][  ][  ][Wr]
[Wu][  ][  ][  ][  ][  ][  ][  ]
[B ][Wl][  ][  ][  ][  ][B ][Ex]
