[D ][B ][  ][  ][  ][Wd][B ][  ]
[  ][Wu][  ][B ][  ][  ][Wl][  ]
[Hl][  ][  ][Wl][  ][  ][  ][  ]
[B ][  ][  ][B ][  ][B ][B ][B ]
[B ][  ][Wl][  ][  ][  ][  ][  ]
[  ][Hl][Wl][  ][  ][B ][  ][  ]
[  ][  ][Hr][  ][  ][  ][  ][  ]
[  ][  ][  ][  ][  ][  ][  ][Ex]
