[D ][  ][  ][  ][Hu][  ][  ][  ]
[  ][  ][Wu][  ][  ][Hu][  ][  ]
[B ][  ][  ][  ][Hr][  ][  ][  ]
[  ][  ][  ][  ][  ][Hd][  ][Wr]
[  ][  ][  ][  ][  ][  ][Wl][  ]
[  ][Wd][  ][  ][  ][  ][  ][  ]
[  ][Wr][  ][Wd][  ][  ][  ][  ]
[  ][  ][  ][  ][  ][  ][Wd][Ex]
