[D ][  ][  ][  ][  ][Hl][  ][  ]
[  ][B ][  ][  ][  ][  ][  ][  ]
[  ][  ][  ][  ][  ][  ][B ][  ]
[Hr][Hu][  ][Wr][  ][  ][  ][  ]
[  ][  ][  ][  ][  ][  ][  ][  ]
[  ][  ][  ][  ][Hl][  ][  ][Wr]
[  ][  ][Wr][  ][  ][Hd][  ][  ]
[  ][  ][  ][Hr][Hu][  ][  ][Ex]
