[D ][  ][B ][  ][Wl][B ][Wl][  ]
[  ][  ][Wl][  ][  ][  ][  ][  ]
[  ][  ][  ][Wl][  ][Wu][  ][  ]
[Wu][  ][  ][B ][Wu][  ][  ][  ]
[  ][  ][B ][  ][  ][  ][  ][Wr]
[  ][  ][  ][Wd][  ][  ][  ][Wr]
[  ][Wd][  ][  ][  ][  ][  ][  ]
[  ][  ][  ][  ][  ][Hu][B ][Ex]
