[D ][B ][  ][  ][  ][  ][  ][  ]
[  ][  ][  ][  ][  ][  ][  ][  ]
[  ][  ][  ][B ][  ][  ][B ][  ]
[  ][B ][B ][  ][  ][  ][  ][  ]
[Hd][  ][  ][  ][  ][Hu][  ][Wr]
[  ][  ][  ][  ][B ][  ][B ][Wr]
[  ][  ][  ][  ][  ][Wd][  ][  ]
[  ][  ][  ][  ][Hl][  ][  ][Ex]
