[D ][B ][  ][  ][  ][  ][  ][  ]
[  ][  ][  ][  ][Hu][  ][  ][  ]
[Wl][Wd][  ][B ][  ][B ][B ][  ]
[  ][B ][B ][  ][  ][  ][  ][  ]
[Hd][  ][  ][  ][  ][Hu][  ][Wr]
[Wr][  ][  ][  ][B ][  ][  ][  ]
[  ][B ][  ][  ][  ][Wd][  ][Hl]
[  ][Hd][  ][  ][B ][  ][B ][Ex]
