[D ][  ][B ][B ][  ][  ][  ][Hr]
[  ][B ][Hd][  ][  ][  ][  ][  ]
[  ][  ][  ][Wl][  ][Wu][  ][  ]
[  ][Wd][  ][B ][Wu][B ][  ][  ]
[  ][  ][  ][  ][  ][  ][  ][B ]
[  ][  ][Hl][B ][B ][  ][  ][Wr]
[  ][Wd][  ][  ][Wr][Hd][  ][  ]
[  ][  ][  ][  ][Hu][  ][  ][Ex]
