[D ][  ][  ][  ][  ][  ][Wu][  ]
[  ][Wu][  ][  ][  ][B ][  ][  ]
[  ][  ][  ][  ][  ][  ][  ][  ]
[B ][  ][  ][  ][  ][Hr][  ][B ]
[  ][  ][Hr][  ][  ][  ][  ][B ]
[  ][Hr][  ][  ][  ][  ][  ][B ]
[  ][  ][  ][  ][Wl][  ][  ][  ]
[Hu][Wd][  ][Hu][Wd][  ][  ][Ex]
