[D ][  ][  ][  ][Hu][  ][  ][  ]
[B ][  ][  ][  ][  ][Hu][  ][Wd]
[  ][  ][Wr][  ][  ][  ][  ][  ]
[  ][  ][  ][  ][  ][B ][  ][B ]
[  ][Wr][  ][  ][  ][  ][  ][  ]
[  ][  ][  ][  ][B ][  ][Hr][  ]
[  ][  ][  ][  ][  ][B ][  ][  ]
[Hu][Hr][  ][  ][  ][  ][  ][Ex]
