[D ][  ][  ][  ][  ][B ][  ][Wr]
[Wl][B ][B ][  ][  ][  ][Wr][B ]
[  ][  ][Hl][B ][  ][  ][  ][  ]
[  ][  ][  ][Hu][  ][  ][  ][Wu]
[  ][  ][B ][  ][Hr][Wl][  ][  ]
[  ][  ][B ][  ][  ][  ][B ][  ]
[  ][  ][Wl][B ][  ][  ][  ][  ]
[  ][  ][  ][Hu][Wd][  ][  ][Ex]
