[D ][  ][B ][  ][Hu][  ][  ][  ]
[B ][  ][Wu][  ][  ][Hu][  ][  ]
[B ][B ][  ][Wl][Hr][  ][  ][  ]
[B ][B ][  ][  ][  ][  ][  ][Wr]
[Hd][  ][  ][  ][B ][  ][  ][  ]
[  ][  ][  ][  ][B ][  ][B ][  ]
[Hl][  ][Hu][Wd][  ][  ][  ][  ]
[Wl][  ][  ][  ][  ][  ][Wd][Ex]
