[D ][  ][  ][  ][  ][  ][  ][B ]
[Hl][  ][  ][  ][  ][  ][  ][  ]
[  ][  ][Wd][  ][Hr][  ][B ][  ]
[B ][Wd][  ][  ][B ][  ][  ][  ]
[B ][  ][  ][B ][  ][  ][  ][Wu]
[Wd][Wd][  ][  ][  ][  ][Wu][B ]
[  ][B ][  ][B ][B ][B ][  ][  ]
[B ][Wd][  ][  ][  ][  ][  ][Ex]
