[D ][Hu][  ][B ][  ][B ][B ][  ]
[  ][Wu][B ][Hd][  ][  ][Wl][B ]
[  ][  ][B ][  ][  ][  ][  ][  ]
[B ][  ][  ][  ][B ][  ][  ][B ]
[Wd][  ][Wl][  ][  ][  ][  ][  ]
[  ][Hr][Wl][  ][  ][  ][Wl][B ]
[  ][Wu][  ][  ][B ][B ][  ][  ]
[Wl][  ][  ][  ][  ][  ][  ][Ex]
