[D ][  ][Hr][  ][  ][  ][  ][  ]
[B ][  ][  ][  ][  ][Hu][  ][  ]
[B ][  ][Wr][  ][  ][  ][  ][  ]
[B ][  ][  ][  ][  ][Hd][  ][Wl]
[  ][Wr][Wr][  ][  ][  ][  ][Wd]
[  ][  ][  ][  ][B ][  ][B ][  ]
[  ][  ][Wd][Wd][  ][  ][  ][  ]
[Wd][  ][  ][  ][  ][  ][Wd][Ex]
