[D ][  ][B ][  ][  ][B ][Wl][  ]
[  ][  ][Hd][  ][  ][  ][B ][  ]
[  ][  ][  ][  ][  ][  ][  ][  ]
[  ][  ][  ][B ][Wu][  ][  ][  ]
[  ][  ][B ][  ][  ][Hd][  ][Wr]
[  ][  ][  ][  ][  ][  ][  ][Wr]
[  ][Wd][  ][  ][Wu][Hd][  ][  ]
[  ][  ][  ][Hl][  ][  ][Wu][Ex]
