[D ][  ][  ][  ][Hr][Hl][  ][  ][  ][  ][  ][  ][  ][B ][  ][  ]
[  ][  ][  ][  ][  ][  ][  ][  ][  ][  ][  ][  ][  ][  ][  ][  ]
[  ][  ][Hl][Hl][  ][  ][  ][  ][  ][  ][  ][B ][Wr][  ][  ][  ]
[B ][  ][  ][  ][  ][B ][  ][  ][  ][  ][B ][  ][Wr][  ][  ][  ]
[  ][Wl][  ][  ][  ][Hu][  ][B ][  ][  ][Wu][  ][  ][  ][Wd][  ]
[  ][  ][  ][  ][  ][  ][  ][  ][  ][B ][  ][B ][  ][  ][  ][  ]
[B ][  ][  ][  ][  ][  ][  ][  ][  ][  ][Wr][Wl][  ][  ][  ][  ]
[  ][Wl][  ][  ][  ][  ][Wr][  ][  ][  ][  ][  ][  ][  ][  ][B ]
[  ][  ][  ][  ][  ][  ][  ][  ][  ][  ][  ][  ][  ][  ][  ][Ex]
