[D ][  ][Hr][  ][  ][  ][  ][  ][B ][Wu][  ][  ][  ][  ][  ][  ]
[  ][Wd][  ][  ][  ][  ][  ][  ][  ][  ][  ][  ][  ][  ][  ][  ]
[Hl][  ][  ][  ][  ][  ][  ][  ][  ][  ][  ][Hl][  ][  ][  ][  ]
[  ][  ][  ][  ][  ][  ][  ][  ][  ][  ][  ][  ][  ][  ][  ][  ]
[  ][  ][  ][  ][  ][Wu][  ][  ][  ][  ][  ][B ][  ][  ][  ][  ]
[  ][Wd][B ][  ][  ][  ][  ][  ][  ][  ][  ][  ][  ][Wd][  ][  ]
[  ][  ][  ][  ][  ][Wu][  ][  ][  ][Hr][  ][  ][  ][  ][  ][  ]
[  ][  ][  ][  ][  ][  ][  ][  ][  ][  ][  ][  ][  ][  ][  ][  ]
[  ][  ][  ][Wr][  ][  ][  ][  ][  ][  ][  ][  ][  ][  ][  ][Ex]
