[D ][  ][  ][  ][  ][  ][  ][  ][  ][Wl][  ][  ][  ][  ][  ][  ]
[  ][  ][  ][  ][  ][  ][  ][  ][  ][  ][  ][  ][  ][  ][  ][  ]
[  ][  ][  ][  ][  ][  ][  ][Hd][  ][  ][  ][  ][  ][  ][  ][  ]
[  ][  ][  ][  ][  ][  ][  ][  ][  ][B ][Hl][  ][  ][  ][  ][  ]
[  ][  ][Wr][  ][  ][  ][  ][  ][  ][  ][  ][  ][  ][  ][  ][  ]
[  ][  ][  ][  ][  ][  ][  ][  ][  ][  ][  ][B ][Wu][  ][  ][  ]
[  ][  ][  ][B ][  ][  ][  ][  ][  ][  ][  ][  ][  ][B ][  ][  ]
[  ][Hu][  ][  ][  ][  ][  ][  ][  ][  ][  ][  ][  ][  ][  ][  ]
[  ][  ][  ][  ][  ][Hl][  ][  ][  ][  ][B ][  ][  ][  ][  ][Ex]
