[D ][  ][  ][  ][  ][B ][  ][  ][  ][  ][  ][B ][  ][  ][  ][  ]
[  ][  ][  ][  ][  ][  ][  ][B ][  ][  ][  ][  ][  ][  ][  ][  ]
[  ][  ][  ][  ][B ][  ][  ][  ][  ][  ][Hu][  ][  ][  ][  ][  ]
[Hl][  ][  ][Wu][  ][  ][  ][  ][  ][  ][  ][  ][  ][  ][  ][  ]
[  ][  ][  ][  ][  ][  ][  ][Wl][  ][  ][  ][  ][  ][  ][B ][  ]
[  ][  ][  ][  ][  ][  ][Hr][  ][  ][  ][  ][  ][  ][  ][  ][  ]
[  ][  ][Wd][  ][  ][  ][  ][  ][  ][  ][  ][  ][  ][  ][  ][  ]
[B ][B ][  ][  ][  ][  ][Wd][  ][  ][  ][  ][  ][  ][  ][  ][  ]
[  ][  ][  ][Wl][  ][  ][  ][  ][  ][Hd][  ][  ][  ][  ][  ][Ex]
