[D ][  ][  ][  ][  ][  ][  ][  ][B ][B ][  ][Hr][  ][  ][  ][B ]
[  ][  ][  ][  ][  ][  ][  ][  ][  ][  ][  ][  ][  ][Wd][  ][  ]
[  ][  ][  ][  ][  ][B ][  ][  ][B ][  ][  ][B ][  ][  ][  ][Hr]
[B ][  ][  ][  ][  ][  ][  ][  ][B ][  ][Wu][  ][  ][B ][  ][  ]
[Hr][  ][  ][  ][Wu][  ][  ][  ][  ][  ][  ][  ][  ][B ][B ][  ]
[  ][  ][  ][  ][  ][B ][Wl][  ][  ][  ][  ][  ][  ][  ][B ][  ]
[  ][  ][  ][  ][  ][  ][B ][  ][  ][  ][  ][  ][  ][  ][  ][  ]
[  ][  ][B ][  ][  ][  ][  ][  ][  ][Hl][  ][B ][  ][  ][  ][  ]
[  ][B ][  ][  ][  ][  ][  ][  ][  ][  ][  ][  ][B ][  ][  ][Ex]
