[D ][  ][  ][  ][B ][  ][  ][  ][  ][  ][  ][  ][  ][  ][  ][Wl]
[  ][B ][  ][Wd][  ][  ][Wu][  ][  ][  ][  ][  ][  ][  ][  ][  ]
[  ][  ][Hl][  ][  ][  ][  ][  ][  ][  ][  ][B ][  ][  ][Wd][  ]
[  ][  ][  ][  ][  ][B ][  ][  ][  ][  ][  ][  ][  ][  ][  ][  ]
[  ][Wl][  ][  ][  ][  ][  ][  ][  ][  ][Hr][  ][  ][  ][  ][  ]
[  ][  ][  ][  ][  ][  ][  ][  ][  ][  ][  ][  ][  ][  ][  ][  ]
[  ][  ][  ][B ][  ][  ][  ][  ][  ][  ][  ][  ][  ][Hu][  ][  ]
[  ][  ][  ][  ][  ][  ][B ][  ][  ][  ][  ][  ][  ][  ][  ][  ]
[  ][  ][  ][  ][  ][  ][  ][  ][  ][  ][  ][  ][  ][  ][  ][Ex]
