[D ][  ][  ][  ][  ][  ][  ][  ][  ][  ][  ][  ][  ][  ][  ][Wu]
[  ][Hd][  ][  ][  ][  ][  ][  ][  ][  ][  ][Hd][Wd][  ][  ][  ]
[B ][B ][Hl][  ][B ][Hd][  ][  ][  ][  ][  ][B ][  ][  ][Wl][  ]
[B ][  ][  ][  ][  ][  ][  ][  ][  ][  ][  ][  ][  ][  ][  ][  ]
[  ][Wl][  ][  ][  ][  ][  ][  ][  ][  ][Wu][  ][  ][  ][  ][  ]
[  ][  ][B ][  ][  ][  ][  ][  ][  ][  ][  ][  ][  ][  ][  ][  ]
[B ][  ][  ][B ][  ][  ][Wr][  ][B ][  ][  ][  ][  ][  ][  ][  ]
[  ][  ][Wd][Hl][  ][  ][Wr][  ][  ][  ][  ][  ][  ][  ][  ][  ]
[  ][  ][  ][  ][  ][  ][  ][  ][  ][  ][  ][B ][  ][  ][  ][Ex]
