[D ][  ][  ][  ][  ][  ][  ][  ][  ][  ][  ][  ][  ][  ][  ][Wu]
[  ][Hd][  ][  ][  ][  ][Wu][  ][  ][  ][  ][Hd][Wd][  ][  ][  ]
[  ][  ][Hl][  ][  ][Hd][  ][  ][  ][  ][  ][B ][  ][  ][  ][  ]
[B ][  ][  ][  ][  ][  ][  ][  ][  ][  ][  ][  ][  ][  ][  ][  ]
[  ][Wl][  ][  ][  ][  ][  ][  ][  ][  ][Wu][  ][  ][  ][  ][  ]
[  ][  ][  ][  ][  ][  ][  ][  ][  ][  ][  ][  ][  ][  ][  ][  ]
[  ][  ][  ][  ][  ][  ][  ][  ][  ][  ][  ][Wl][  ][  ][  ][  ]
[  ][  ][  ][Hl][  ][  ][  ][  ][  ][B ][  ][  ][  ][  ][  ][  ]
[  ][  ][B ][  ][  ][  ][Hu][  ][  ][  ][  ][  ][  ][  ][  ][Ex]
