[  ][Ex][  ][B ][  ][  ][Hr][  ][B ][B ][  ][  ][Wd][  ][  ][  ]
[  ][  ][Hl][  ][  ][  ][B ][B ][  ][  ][  ][D ][Hd][  ][  ][  ]
[  ][  ][  ][  ][  ][  ][  ][  ][  ][  ][  ][  ][  ][B ][  ][Wl]
[  ][  ][  ][Wd][  ][  ][  ][  ][  ][  ][  ][  ][  ][  ][  ][  ]
[B ][  ][  ][  ][  ][  ][B ][Hr][  ][  ][Hr][  ][  ][Hu][  ][  ]
[  ][  ][  ][  ][  ][Wr][  ][B ][  ][  ][B ][  ][  ][  ][  ][  ]
[  ][  ][Hr][Hl][Hl][  ][  ][Hu][  ][  ][  ][B ][  ][  ][  ][Hu]
[  ][  ][  ][  ][  ][  ][Wu][  ][  ][  ][  ][  ][Wd][  ][  ][  ]
[  ][Wl][Hr][  ][  ][B ][  ][Wd][  ][  ][B ][Wd][  ][  ][  ][  ]
