[  ][Ex][Wu][  ][  ][  ][Wl][  ][  ][  ][  ][  ][Wd][  ][  ][  ]
[  ][  ][  ][  ][  ][  ][B ][  ][  ][  ][  ][D ][Hd][B ][  ][  ]
[  ][Wl][  ][  ][Hu][  ][Wl][  ][  ][  ][  ][  ][  ][  ][  ][  ]
[  ][  ][  ][Wd][  ][  ][  ][B ][  ][  ][  ][  ][  ][B ][  ][  ]
[B ][  ][  ][  ][  ][Wr][B ][  ][Hd][  ][Hd][  ][  ][Hu][  ][  ]
[  ][  ][  ][  ][Wd][  ][B ][  ][Wr][  ][  ][B ][  ][  ][  ][  ]
[B ][B ][  ][Hl][  ][B ][  ][  ][  ][  ][  ][B ][Hr][  ][  ][B ]
[  ][Hl][B ][  ][B ][  ][B ][  ][  ][  ][  ][Wl][  ][  ][  ][Hl]
[  ][  ][Hr][  ][  ][  ][  ][  ][  ][  ][  ][  ][  ][B ][  ][  ]
