[  ][Ex][  ][  ][  ][  ][  ][  ][B ][  ][  ][  ][Wd][B ][  ][  ]
[  ][  ][Hl][  ][  ][  ][B ][B ][Hu][  ][  ][D ][  ][  ][  ][Hl]
[  ][  ][  ][  ][  ][  ][  ][  ][  ][  ][  ][  ][  ][  ][  ][Hd]
[  ][Wu][  ][Wd][  ][  ][  ][  ][  ][  ][  ][  ][  ][  ][  ][  ]
[  ][  ][  ][  ][  ][  ][  ][Hd][Wu][  ][  ][B ][  ][  ][  ][Wd]
[  ][  ][  ][Wr][  ][Hl][  ][  ][  ][  ][B ][  ][  ][  ][  ][  ]
[  ][  ][  ][Hl][  ][  ][  ][  ][B ][  ][  ][B ][Wd][  ][  ][Wu]
[  ][  ][Hd][  ][  ][  ][Wu][  ][  ][  ][  ][  ][  ][  ][  ][  ]
[  ][  ][  ][  ][  ][B ][  ][Wd][  ][  ][B ][Wd][Wu][  ][Wl][  ]
