[  ][Ex][  ][Hd][B ][  ][  ][  ][  ][  ][Hl][  ][  ][  ][  ][  ]
[  ][  ][  ][  ][  ][  ][  ][  ][  ][  ][  ][D ][  ][Wd][  ][  ]
[Hl][  ][  ][  ][Hu][  ][B ][  ][  ][  ][  ][  ][  ][  ][  ][  ]
[  ][  ][  ][  ][  ][  ][  ][  ][  ][  ][  ][  ][  ][  ][  ][  ]
[  ][  ][  ][Wl][  ][  ][  ][  ][Hu][Wl][  ][  ][  ][  ][  ][  ]
[  ][  ][  ][  ][  ][  ][  ][  ][  ][  ][Wd][  ][  ][  ][B ][  ]
[  ][  ][Wu][  ][  ][  ][  ][  ][  ][  ][  ][  ][  ][  ][  ][  ]
[  ][  ][  ][  ][  ][  ][  ][  ][  ][  ][  ][  ][  ][  ][  ][Wl]
[  ][  ][  ][  ][  ][Wu][  ][  ][  ][  ][  ][  ][  ][  ][  ][  ]
