[  ][Ex][  ][  ][B ][B ][  ][  ][  ][  ][  ][  ][Wl][  ][  ][Wd]
[Hd][  ][  ][  ][  ][  ][  ][Wu][  ][Wl][Wr][D ][  ][Wd][Wu][  ]
[  ][  ][  ][  ][  ][  ][Hu][  ][  ][Hd][  ][  ][B ][  ][  ][  ]
[  ][  ][  ][  ][  ][  ][  ][  ][  ][  ][  ][Wl][B ][B ][  ][  ]
[  ][  ][  ][  ][  ][  ][  ][  ][  ][  ][  ][B ][B ][B ][  ][  ]
[  ][  ][  ][  ][  ][  ][  ][  ][  ][  ][B ][  ][  ][B ][  ][  ]
[  ][  ][  ][Hr][  ][  ][  ][  ][  ][  ][  ][Hu][  ][Hl][  ][  ]
[  ][  ][  ][  ][  ][Wd][  ][  ][  ][  ][  ][  ][  ][  ][Wr][  ]
[  ][Hr][  ][  ][  ][Hd][  ][  ][Wd][  ][  ][  ][  ][  ][  ][  ]
