[  ][Ex][  ][B ][  ][  ][Hr][  ][B ][B ][  ][  ][Wd][  ][  ][  ]
[  ][  ][  ][  ][  ][  ][B ][B ][  ][Wr][  ][D ][Hd][  ][B ][  ]
[  ][  ][  ][  ][  ][  ][  ][  ][  ][  ][  ][  ][  ][B ][  ][Wl]
[  ][  ][  ][Wd][  ][  ][  ][  ][  ][  ][  ][  ][  ][  ][  ][  ]
[B ][  ][  ][  ][  ][  ][B ][Hr][  ][  ][Hr][  ][  ][Hu][  ][  ]
[  ][  ][  ][  ][  ][  ][  ][  ][  ][  ][B ][  ][  ][  ][  ][  ]
[  ][  ][Hr][  ][Hl][  ][  ][Hu][Wu][  ][  ][B ][  ][  ][  ][Hu]
[  ][  ][  ][  ][  ][  ][  ][  ][B ][  ][  ][  ][Wd][  ][  ][  ]
[  ][  ][Hr][  ][  ][B ][  ][Wd][  ][  ][B ][Wd][  ][  ][  ][  ]
