[  ][Ex][Hr][  ][  ][  ][  ][  ][  ][  ][  ][  ][Hu][  ][  ][Hl]
[  ][  ][  ][  ][  ][  ][  ][  ][  ][  ][  ][D ][  ][  ][  ][  ]
[  ][  ][Hr][  ][  ][  ][B ][  ][  ][  ][  ][  ][  ][  ][  ][Wu]
[  ][  ][Wl][  ][B ][  ][  ][Hr][  ][B ][  ][Wl][  ][Hl][  ][  ]
[  ][  ][  ][  ][  ][Hr][  ][  ][  ][  ][B ][B ][  ][  ][Wu][  ]
[  ][  ][  ][  ][  ][B ][B ][  ][  ][  ][B ][  ][  ][  ][  ][  ]
[  ][B ][  ][Hl][  ][  ][  ][  ][  ][  ][B ][  ][Wd][B ][  ][B ]
[  ][Wl][  ][  ][  ][Wd][Wu][  ][  ][  ][  ][  ][Wu][  ][  ][  ]
[Hu][Wl][  ][  ][Hl][Hu][  ][  ][  ][  ][B ][Hl][  ][  ][Wl][  ]
