[  ][Ex][  ][  ][B ][  ][  ][  ][  ][  ][  ][  ][Wl][B ][Wd][Hu]
[  ][  ][B ][  ][  ][  ][  ][  ][  ][B ][Wr][D ][  ][Wd][  ][  ]
[  ][  ][  ][  ][  ][  ][  ][B ][  ][  ][  ][  ][  ][Wu][Hr][  ]
[  ][  ][B ][  ][Wu][  ][  ][  ][  ][  ][  ][Wl][  ][B ][  ][  ]
[  ][Wd][  ][  ][  ][  ][B ][  ][  ][  ][  ][  ][B ][B ][Wu][  ]
[Hl][  ][Wu][  ][B ][Hu][  ][  ][  ][  ][  ][  ][Hu][  ][  ][Hd]
[  ][  ][  ][  ][  ][Hl][  ][  ][Hr][  ][Wr][B ][  ][  ][  ][  ]
[  ][  ][  ][  ][  ][Wd][  ][  ][  ][  ][  ][  ][  ][  ][  ][  ]
[  ][  ][B ][Wr][  ][Hd][  ][  ][Wd][  ][  ][  ][  ][  ][  ][Wd]
