[  ][Ex][  ][  ][  ][Wl][Wl][  ][B ][  ][  ][  ][Wd][  ][  ][  ]
[  ][  ][  ][  ][  ][  ][  ][  ][Hd][  ][  ][D ][Hd][B ][  ][  ]
[  ][Wl][  ][  ][Hu][  ][Wl][  ][  ][Wr][  ][Wu][  ][B ][  ][  ]
[  ][  ][  ][Wd][  ][  ][  ][  ][  ][  ][  ][  ][  ][  ][  ][  ]
[B ][Wu][  ][  ][  ][  ][B ][Hr][  ][  ][Hr][  ][  ][Hu][B ][  ]
[  ][  ][  ][  ][  ][Wr][B ][  ][Wr][  ][Wl][  ][  ][B ][  ][  ]
[B ][  ][Hr][Hl][Hl][B ][  ][  ][  ][  ][  ][B ][  ][  ][  ][  ]
[  ][  ][B ][  ][  ][  ][  ][  ][B ][  ][  ][Wl][Wd][  ][  ][Hr]
[  ][  ][Hr][  ][  ][  ][  ][Wd][  ][  ][B ][Wd][  ][B ][  ][  ]
