[  ][Ex][  ][  ][  ][  ][  ][  ][  ][  ][  ][  ][  ][  ][  ][Hl]
[  ][Wu][  ][  ][  ][  ][  ][  ][  ][B ][Wr][D ][B ][  ][  ][  ]
[  ][  ][  ][Hl][  ][  ][B ][  ][  ][  ][  ][  ][  ][  ][  ][  ]
[  ][  ][  ][  ][  ][  ][  ][  ][  ][B ][  ][Wl][Hl][  ][  ][  ]
[  ][  ][  ][  ][  ][  ][  ][Hd][  ][  ][  ][B ][Hu][  ][  ][  ]
[Hl][  ][  ][  ][  ][  ][  ][  ][  ][  ][B ][  ][B ][Wl][  ][Hr]
[  ][  ][Hd][Hl][Wl][  ][  ][B ][Hr][  ][  ][  ][Wd][B ][  ][B ]
[  ][  ][  ][  ][Hu][  ][Wd][  ][  ][B ][  ][Wu][  ][Wl][  ][  ]
[  ][  ][  ][Wd][B ][Wu][  ][B ][Hr][  ][B ][Wd][  ][  ][Wl][  ]
