[  ][Ex][  ][B ][  ][Wl][Hr][B ][B ][  ][  ][Wu][Wd][  ][  ][  ]
[  ][  ][  ][  ][  ][  ][B ][Hl][Hd][  ][  ][D ][Hd][B ][B ][  ]
[  ][  ][  ][  ][  ][  ][Wl][  ][  ][Wr][  ][  ][  ][B ][  ][  ]
[  ][  ][  ][Wd][  ][  ][  ][  ][  ][  ][Hu][  ][  ][  ][  ][  ]
[B ][Wu][  ][  ][  ][  ][  ][Hr][  ][  ][Hr][Wd][  ][Hu][B ][  ]
[  ][  ][  ][  ][  ][Wr][  ][  ][  ][  ][Wl][  ][  ][  ][  ][  ]
[  ][  ][Wu][Hl][Hl][B ][  ][  ][  ][  ][  ][B ][  ][  ][  ][Hu]
[  ][  ][  ][  ][  ][  ][  ][  ][B ][  ][  ][Wl][Wd][  ][  ][Hl]
[  ][  ][  ][  ][  ][  ][  ][Wd][  ][  ][B ][Wd][  ][  ][  ][  ]
