[  ][Ex][Hr][  ][B ][  ][  ][  ][  ][  ][B ][  ][Hu][  ][  ][Hl]
[  ][  ][  ][  ][  ][  ][  ][  ][  ][  ][  ][D ][  ][B ][  ][  ]
[  ][  ][Hl][  ][  ][  ][B ][B ][  ][Hd][  ][  ][  ][  ][  ][Wu]
[  ][  ][Wl][  ][B ][  ][  ][Hd][  ][B ][  ][Wl][  ][Hl][Hu][  ]
[  ][  ][  ][  ][B ][Hl][Hd][  ][  ][  ][B ][B ][  ][  ][Wu][  ]
[  ][  ][  ][  ][  ][B ][B ][  ][  ][  ][B ][  ][  ][  ][  ][Wu]
[  ][B ][  ][  ][  ][  ][  ][  ][  ][  ][B ][  ][Wd][B ][  ][Wl]
[B ][Wl][  ][  ][  ][Wd][Wu][  ][  ][  ][  ][  ][Wu][  ][  ][  ]
[Hu][Wl][  ][  ][Hl][Hu][  ][  ][  ][  ][B ][Hl][  ][  ][Wl][  ]
