[  ][Ex][  ][  ][  ][  ][  ][  ][  ][Wd][  ][  ][  ][  ][  ][B ]
[Hl][Wu][  ][  ][  ][  ][B ][  ][  ][  ][Wr][D ][B ][  ][  ][  ]
[  ][  ][  ][  ][  ][  ][B ][  ][  ][  ][  ][  ][  ][  ][  ][  ]
[  ][  ][  ][  ][  ][  ][  ][  ][  ][  ][  ][Wl][Hl][  ][  ][  ]
[  ][  ][  ][  ][  ][  ][Wr][Hd][  ][  ][B ][B ][  ][  ][  ][  ]
[Hl][  ][  ][  ][  ][B ][  ][  ][  ][  ][B ][  ][  ][Wl][  ][  ]
[  ][  ][  ][Hl][Wl][  ][  ][B ][  ][  ][  ][  ][Wd][B ][  ][B ]
[  ][  ][  ][  ][Hu][  ][  ][  ][  ][B ][  ][  ][  ][Wl][  ][  ]
[  ][  ][  ][  ][B ][  ][Hr][  ][Hr][  ][B ][Wd][  ][  ][Wl][B ]
