[  ][Ex][  ][  ][B ][B ][  ][  ][  ][  ][  ][  ][Wl][  ][  ][Wd]
[Hd][  ][  ][  ][  ][  ][  ][  ][  ][Wl][Wr][D ][  ][Wd][Wr][  ]
[  ][  ][  ][  ][  ][  ][Hu][  ][  ][Hd][Wl][  ][B ][  ][  ][  ]
[  ][  ][  ][B ][  ][  ][  ][  ][  ][  ][  ][Wl][B ][B ][  ][  ]
[  ][  ][  ][B ][  ][  ][  ][  ][  ][  ][  ][B ][B ][B ][  ][  ]
[  ][  ][  ][  ][  ][  ][  ][  ][  ][  ][B ][  ][  ][B ][  ][  ]
[  ][  ][  ][Hr][  ][  ][  ][  ][  ][  ][  ][Hu][  ][Hl][  ][  ]
[  ][  ][  ][  ][  ][Wd][  ][  ][  ][  ][  ][  ][  ][  ][Wr][  ]
[  ][Hr][  ][  ][  ][  ][  ][  ][Wd][  ][  ][  ][  ][  ][  ][  ]
