[  ][Ex][  ][  ][  ][  ][  ][  ][  ][  ][  ][B ][  ][  ][Wr][  ]
[  ][Wu][Hu][B ][  ][  ][  ][  ][  ][B ][Hl][D ][B ][Wr][B ][  ]
[  ][  ][  ][Hl][  ][  ][B ][  ][  ][Wr][  ][  ][  ][  ][B ][  ]
[  ][  ][  ][  ][  ][  ][  ][  ][  ][B ][  ][Wl][Hl][  ][  ][  ]
[  ][  ][  ][  ][  ][  ][  ][Wl][  ][  ][  ][B ][Hu][  ][  ][  ]
[Hl][  ][  ][Wr][Wd][  ][  ][  ][  ][  ][B ][  ][B ][Wl][  ][Hr]
[  ][  ][Hd][Hl][  ][  ][Hu][B ][Hr][  ][  ][  ][Wd][B ][  ][B ]
[  ][  ][  ][  ][Hu][  ][Wd][B ][  ][B ][  ][Wu][  ][Wl][  ][  ]
[  ][  ][  ][Hl][Wl][Wu][  ][B ][Hr][  ][  ][Wd][  ][B ][Wl][  ]
