[  ][Ex][  ][  ][  ][  ][  ][  ][B ][  ][  ][  ][Wd][  ][  ][  ]
[  ][  ][Hl][  ][  ][  ][B ][B ][  ][  ][  ][D ][  ][  ][  ][Hl]
[  ][  ][  ][  ][Wd][  ][  ][  ][  ][  ][  ][  ][  ][B ][  ][Wl]
[  ][  ][  ][Wd][  ][  ][  ][  ][  ][  ][  ][  ][  ][  ][  ][  ]
[  ][  ][  ][  ][  ][  ][B ][Hd][Wu][  ][  ][  ][  ][  ][  ][  ]
[  ][  ][  ][Wr][  ][Wl][Wl][B ][  ][  ][B ][  ][  ][  ][  ][  ]
[Hu][  ][Hr][Hl][B ][  ][  ][  ][  ][  ][  ][B ][Wd][  ][  ][Wu]
[  ][  ][  ][  ][  ][  ][Wu][  ][  ][  ][  ][  ][  ][  ][  ][  ]
[  ][Wl][  ][  ][  ][B ][  ][Wd][  ][  ][B ][Wd][  ][  ][  ][  ]
