[  ][Ex][  ][  ][  ][Wl][Wl][  ][B ][  ][  ][  ][Wd][  ][  ][  ]
[  ][  ][  ][  ][  ][  ][B ][  ][Hd][  ][  ][D ][Hd][Hl][  ][  ]
[  ][Wl][  ][  ][Hu][  ][Wl][  ][  ][Wr][  ][  ][  ][B ][  ][  ]
[  ][  ][  ][  ][  ][  ][  ][  ][  ][  ][  ][  ][  ][  ][  ][  ]
[B ][Wu][  ][  ][  ][  ][B ][Hr][  ][  ][Hr][  ][  ][Hu][B ][  ]
[  ][  ][  ][  ][  ][Wr][  ][  ][Wr][  ][Wl][  ][  ][B ][  ][B ]
[B ][B ][Hr][Hl][Hl][B ][  ][  ][  ][  ][  ][B ][  ][  ][  ][  ]
[  ][  ][B ][  ][B ][  ][  ][  ][B ][  ][  ][Wl][Wd][  ][  ][Hl]
[  ][  ][Hr][  ][  ][  ][  ][Wd][  ][  ][B ][Wd][  ][B ][  ][  ]
