[  ][Ex][  ][  ][B ][  ][  ][  ][  ][  ][  ][B ][Wl][  ][  ][Hl]
[  ][  ][B ][  ][  ][  ][  ][  ][  ][B ][Wr][D ][  ][Wd][  ][  ]
[  ][  ][Wd][  ][  ][Wu][  ][  ][  ][  ][  ][  ][  ][  ][Hd][  ]
[  ][  ][  ][  ][Wr][  ][Wl][  ][B ][  ][  ][Wl][Hl][B ][  ][  ]
[  ][  ][  ][  ][Hr][  ][  ][Hd][  ][  ][  ][B ][  ][B ][Wu][  ]
[Hl][  ][Hr][  ][B ][  ][B ][  ][  ][  ][  ][  ][B ][  ][  ][Hr]
[  ][  ][Hd][  ][B ][  ][  ][  ][Hr][  ][Wr][  ][Wd][Hd][  ][B ]
[Hd][  ][  ][  ][  ][Wd][  ][  ][  ][  ][  ][  ][  ][  ][Wr][  ]
[  ][B ][Hu][  ][  ][  ][  ][  ][Hr][  ][B ][  ][  ][  ][  ][  ]
