[  ][Ex][  ][  ][  ][  ][  ][  ][  ][  ][  ][  ][  ][  ][  ][Hl]
[  ][  ][  ][  ][  ][  ][  ][  ][  ][B ][Wr][D ][  ][Wr][  ][  ]
[  ][  ][  ][  ][  ][  ][B ][  ][  ][  ][  ][  ][  ][  ][  ][  ]
[  ][  ][  ][  ][  ][  ][  ][  ][  ][  ][  ][Wl][Hl][  ][  ][  ]
[  ][  ][  ][  ][  ][  ][  ][Hd][  ][  ][  ][B ][Hu][  ][  ][  ]
[Hl][  ][  ][  ][  ][  ][  ][  ][  ][  ][  ][  ][B ][Wl][  ][Hr]
[  ][  ][Hd][  ][Wl][  ][  ][  ][Hr][  ][  ][  ][Wd][  ][  ][B ]
[  ][  ][  ][  ][  ][Wd][  ][  ][  ][  ][  ][Wu][  ][Wl][  ][  ]
[Hu][  ][  ][  ][  ][Wu][  ][  ][Hr][  ][B ][  ][  ][  ][Wl][  ]
