[  ][Hu][  ][B ][  ][Hu][  ][  ][  ][  ][  ][  ][Hd][Wd][  ][  ]
[B ][  ][Wd][  ][  ][B ][  ][  ][  ][  ][  ][  ][  ][  ][  ][  ]
[  ][Wu][  ][  ][  ][  ][  ][  ][  ][  ][B ][  ][  ][D ][  ][Hu]
[  ][  ][  ][  ][  ][B ][  ][B ][  ][  ][Hu][B ][  ][  ][  ][  ]
[  ][B ][  ][  ][  ][  ][Wu][  ][  ][Hl][  ][Wl][  ][  ][  ][Hr]
[  ][B ][  ][  ][  ][  ][  ][  ][  ][  ][  ][  ][  ][  ][  ][  ]
[Wu][Wd][  ][  ][  ][  ][  ][  ][Wu][Ex][  ][  ][B ][B ][  ][Wd]
[  ][Hu][  ][  ][  ][  ][B ][Wr][Wu][  ][  ][  ][  ][  ][Wr][  ]
[  ][Wu][  ][  ][Wu][Hr][  ][  ][  ][  ][  ][  ][  ][  ][B ][  ]
