[  ][Hu][  ][  ][Wu][Hu][  ][  ][  ][  ][B ][  ][Hd][  ][  ][  ]
[  ][Hu][Wd][  ][  ][  ][  ][  ][  ][  ][  ][  ][  ][  ][  ][  ]
[  ][Wu][Hr][  ][B ][  ][  ][  ][Hl][  ][B ][  ][  ][D ][  ][Hu]
[  ][  ][  ][  ][  ][  ][  ][B ][Hl][  ][  ][  ][  ][  ][  ][  ]
[Wr][  ][  ][  ][  ][Wu][  ][  ][  ][Hl][Hr][Wl][  ][  ][  ][  ]
[  ][  ][  ][  ][  ][  ][  ][B ][  ][  ][  ][  ][  ][  ][  ][  ]
[B ][Wd][  ][  ][Wu][  ][B ][  ][Wu][Ex][  ][  ][B ][  ][  ][Wd]
[  ][Hu][  ][  ][  ][B ][B ][  ][Wu][  ][Wr][  ][Hd][  ][Wr][  ]
[  ][Wu][  ][  ][Wd][Hr][  ][  ][  ][  ][  ][Wr][  ][  ][Wl][  ]
