[  ][Hu][  ][B ][  ][Hu][  ][  ][  ][  ][  ][  ][  ][Wd][  ][  ]
[B ][  ][Wd][  ][  ][  ][  ][  ][  ][  ][  ][  ][  ][  ][  ][  ]
[  ][Wu][  ][  ][  ][  ][  ][  ][  ][  ][B ][  ][  ][D ][  ][Hu]
[  ][  ][  ][  ][  ][B ][  ][Wu][  ][  ][Hu][  ][  ][  ][  ][  ]
[  ][B ][  ][B ][  ][Wu][  ][  ][  ][Hl][Hr][Wl][  ][  ][  ][Hr]
[  ][B ][  ][  ][  ][  ][  ][  ][  ][  ][  ][  ][  ][  ][  ][  ]
[Wu][Wd][  ][  ][  ][  ][B ][  ][Wu][Ex][  ][  ][B ][B ][  ][Wd]
[  ][Hu][  ][  ][  ][  ][B ][Wr][  ][  ][  ][  ][  ][  ][Wr][  ]
[  ][Wu][  ][  ][Wu][Hr][  ][  ][  ][  ][  ][  ][  ][  ][Wu][  ]
