[  ][Hu][  ][  ][Wu][Hu][  ][  ][  ][  ][B ][  ][Hd][  ][  ][  ]
[B ][Hu][Wd][  ][  ][  ][Hr][  ][  ][  ][  ][  ][  ][  ][  ][  ]
[  ][Wu][  ][  ][  ][  ][  ][  ][  ][  ][  ][  ][  ][D ][  ][Hu]
[  ][  ][  ][  ][  ][  ][  ][B ][Hl][  ][  ][  ][Wu][Wr][  ][  ]
[Wr][  ][  ][  ][  ][  ][  ][  ][  ][Hl][B ][  ][  ][  ][  ][  ]
[  ][  ][  ][  ][  ][  ][  ][  ][  ][  ][  ][  ][  ][  ][  ][  ]
[B ][Wd][  ][  ][Wu][  ][B ][  ][Wu][Ex][  ][  ][  ][  ][  ][Wd]
[  ][Hu][  ][  ][  ][  ][B ][  ][Wu][  ][  ][  ][  ][  ][Wr][  ]
[  ][Wu][  ][  ][  ][B ][  ][  ][  ][  ][  ][Wr][Hl][  ][Wl][Hd]
