[  ][  ][  ][B ][  ][  ][  ][  ][Wu][  ][  ][  ][  ][  ][  ][  ]
[B ][  ][Wu][  ][  ][Wl][  ][  ][Hd][  ][  ][  ][  ][  ][Wr][  ]
[Wl][Hl][  ][  ][  ][  ][B ][  ][  ][  ][  ][  ][  ][D ][  ][Hu]
[  ][  ][  ][B ][  ][  ][  ][B ][  ][  ][  ][  ][  ][Hr][  ][  ]
[  ][  ][  ][Hr][  ][  ][  ][  ][  ][  ][Wu][  ][  ][  ][  ][Hr]
[  ][  ][B ][Hd][  ][  ][  ][  ][  ][  ][  ][Wr][  ][  ][Wl][  ]
[  ][  ][  ][  ][Hd][  ][  ][B ][  ][Ex][  ][  ][  ][  ][  ][  ]
[  ][  ][Wl][  ][  ][  ][  ][B ][  ][Hd][  ][  ][Hr][  ][  ][  ]
[  ][  ][B ][  ][  ][  ][  ][Hl][  ][  ][  ][  ][  ][  ][  ][  ]
