[  ][Hu][  ][B ][  ][Hu][  ][  ][  ][Wl][  ][  ][Hd][  ][  ][  ]
[B ][  ][  ][  ][  ][  ][  ][  ][  ][  ][  ][  ][  ][  ][  ][  ]
[  ][Wu][  ][  ][  ][  ][  ][  ][  ][  ][  ][  ][  ][D ][  ][Hu]
[  ][  ][  ][  ][  ][B ][  ][B ][  ][  ][Hu][B ][  ][  ][  ][  ]
[Hr][  ][Hl][  ][  ][Wu][Wl][  ][  ][Hl][  ][Wl][  ][  ][  ][  ]
[  ][B ][  ][  ][  ][  ][  ][  ][  ][  ][  ][  ][  ][  ][  ][  ]
[  ][Wd][  ][  ][  ][  ][B ][  ][Wu][Ex][  ][  ][  ][B ][  ][Wd]
[  ][Hu][B ][  ][  ][  ][B ][Wr][Wu][  ][Hr][  ][  ][  ][  ][  ]
[  ][Wu][  ][  ][Wu][Hr][B ][  ][  ][  ][  ][  ][  ][  ][Wu][  ]
