[  ][Hu][  ][B ][  ][  ][  ][  ][  ][  ][B ][  ][Hd][Wd][  ][  ]
[B ][Hu][Wd][  ][  ][  ][Wu][  ][  ][  ][  ][  ][  ][  ][  ][  ]
[  ][Wu][  ][  ][B ][  ][  ][  ][  ][  ][B ][  ][  ][D ][  ][Wd]
[Wl][  ][  ][  ][  ][B ][  ][B ][  ][  ][Hl][  ][  ][  ][  ][  ]
[Wr][B ][  ][  ][  ][Wu][  ][  ][  ][Hl][Hr][Wl][  ][  ][  ][Hu]
[  ][B ][  ][  ][  ][  ][  ][  ][  ][  ][  ][  ][  ][  ][  ][  ]
[B ][Wd][  ][  ][Wu][  ][B ][  ][Wu][Ex][  ][  ][  ][B ][  ][Wd]
[  ][Hu][  ][  ][  ][  ][B ][B ][Wu][  ][  ][  ][Hd][  ][Wr][  ]
[  ][Wu][  ][  ][Wu][Hr][  ][  ][  ][  ][  ][Wr][Hl][B ][Wl][  ]
