[  ][Hu][  ][  ][  ][Hu][  ][  ][  ][Wl][  ][Hu][Hd][  ][  ][  ]
[B ][  ][  ][  ][  ][Wl][  ][  ][  ][  ][  ][Wl][  ][  ][  ][  ]
[  ][Wd][  ][  ][  ][  ][  ][  ][  ][  ][  ][  ][Wr][D ][  ][Hu]
[  ][  ][  ][  ][  ][B ][  ][  ][  ][  ][Hu][B ][  ][  ][  ][  ]
[Hr][  ][Hl][  ][  ][Hr][  ][  ][  ][Hl][Wd][Wl][  ][  ][Hl][Wu]
[  ][  ][  ][  ][  ][  ][  ][  ][  ][  ][  ][  ][  ][  ][B ][  ]
[  ][Wd][Wu][B ][Wu][  ][B ][  ][Wu][Ex][  ][  ][  ][B ][  ][Wd]
[  ][  ][B ][  ][  ][  ][B ][Wr][  ][  ][Hr][  ][Hr][  ][  ][  ]
[  ][Wu][  ][  ][  ][Hr][  ][  ][  ][  ][  ][  ][  ][  ][Wu][  ]
