[B ][Hu][  ][B ][B ][Hu][  ][  ][  ][Hd][B ][  ][Hd][Wd][B ][  ]
[B ][Hu][Wd][  ][  ][  ][  ][  ][  ][  ][  ][  ][  ][  ][  ][  ]
[  ][Wu][  ][  ][B ][  ][  ][  ][Hl][  ][B ][  ][  ][D ][  ][Hu]
[Wl][  ][  ][  ][  ][B ][  ][B ][  ][  ][  ][  ][  ][  ][  ][Wd]
[Wr][B ][B ][  ][  ][  ][  ][  ][  ][Hl][Hr][Wl][  ][  ][B ][Hu]
[  ][B ][  ][  ][  ][  ][  ][  ][  ][  ][  ][  ][  ][  ][  ][  ]
[B ][Wd][  ][  ][Wu][  ][B ][  ][Wu][Ex][  ][  ][B ][B ][  ][Wd]
[  ][Hu][  ][  ][  ][  ][B ][Hr][Wu][  ][  ][  ][Hd][  ][Wr][  ]
[  ][Wu][  ][  ][Wu][Hr][  ][  ][  ][Wl][  ][Wr][Hl][  ][  ][  ]
