[B ][Hu][  ][B ][B ][Hu][B ][  ][  ][  ][  ][  ][Hd][Wd][B ][  ]
[B ][Hu][Wd][  ][  ][  ][Wu][  ][  ][  ][  ][  ][  ][  ][  ][  ]
[  ][Wu][  ][  ][B ][  ][  ][  ][Hl][  ][B ][  ][  ][D ][  ][  ]
[Wl][  ][  ][  ][  ][B ][  ][B ][  ][  ][  ][  ][  ][  ][  ][  ]
[Wr][B ][B ][  ][  ][Wu][  ][  ][  ][Hl][Hr][Wl][  ][  ][B ][Hu]
[  ][B ][  ][  ][  ][  ][  ][  ][  ][  ][  ][  ][  ][  ][Wu][  ]
[B ][Wd][  ][  ][Wu][Hr][B ][  ][Wu][Ex][  ][  ][B ][B ][  ][Wd]
[  ][Hu][  ][  ][  ][  ][B ][Hr][Wu][  ][  ][  ][Hd][  ][Wr][  ]
[  ][Wu][  ][  ][Wu][Hr][  ][  ][  ][Wl][  ][Wr][Hl][  ][  ][  ]
