[  ][Hu][  ][B ][  ][Hu][  ][  ][  ][  ][  ][  ][Hd][  ][  ][  ]
[B ][  ][  ][  ][  ][  ][  ][  ][  ][  ][  ][  ][  ][  ][  ][  ]
[  ][Wu][  ][  ][  ][  ][  ][  ][  ][  ][B ][  ][  ][D ][  ][Hu]
[  ][  ][  ][Wd][  ][Hl][  ][B ][  ][  ][Hu][B ][  ][  ][  ][  ]
[  ][B ][  ][  ][  ][  ][Wu][  ][  ][B ][  ][  ][  ][  ][  ][Hr]
[  ][B ][  ][  ][  ][  ][  ][  ][  ][  ][  ][  ][  ][  ][  ][  ]
[Wu][Wd][  ][  ][  ][  ][B ][  ][Wu][Ex][  ][  ][  ][  ][  ][Wd]
[  ][Hu][  ][  ][  ][  ][B ][  ][Hr][  ][  ][  ][  ][  ][Wr][  ]
[  ][Hd][  ][Wl][Wu][  ][  ][  ][  ][  ][  ][  ][  ][  ][Wu][  ]
