[  ][Hu][  ][  ][  ][  ][  ][  ][  ][  ][  ][  ][Hd][Wd][  ][  ]
[B ][  ][  ][  ][  ][  ][  ][  ][B ][  ][  ][  ][  ][  ][  ][  ]
[Wd][Wu][  ][  ][  ][  ][  ][  ][  ][  ][  ][  ][  ][D ][  ][  ]
[  ][  ][  ][  ][Hr][  ][Hr][B ][  ][  ][  ][B ][  ][  ][  ][  ]
[  ][B ][  ][  ][  ][  ][  ][  ][Hd][  ][Wu][Wl][  ][  ][  ][Hr]
[  ][B ][  ][  ][  ][  ][  ][  ][  ][  ][  ][  ][  ][Wu][  ][  ]
[Wu][  ][  ][  ][  ][  ][  ][  ][Wu][Ex][  ][  ][  ][  ][  ][Wd]
[  ][Hd][  ][  ][  ][  ][B ][Wr][B ][  ][  ][  ][  ][  ][Wr][  ]
[  ][Wu][  ][  ][Wu][Hr][  ][  ][  ][  ][  ][  ][  ][  ][  ][  ]
