[  ][  ][  ][  ][  ][  ][  ][  ][  ][Wd][  ][  ][  ][  ][  ][  ]
[  ][  ][  ][B ][  ][  ][  ][  ][  ][  ][  ][  ][  ][Hl][  ][  ]
[  ][  ][  ][  ][  ][  ][B ][  ][  ][B ][  ][  ][  ][B ][Ex][  ]
[  ][  ][  ][  ][  ][  ][  ][  ][  ][D ][  ][  ][  ][  ][B ][  ]
[  ][  ][Hl][  ][  ][B ][  ][  ][  ][  ][  ][Hl][Hl][  ][  ][  ]
[Hl][B ][  ][  ][  ][  ][  ][  ][Wd][  ][B ][  ][  ][  ][  ][  ]
[  ][  ][  ][  ][  ][  ][  ][  ][  ][B ][B ][  ][  ][  ][  ][Wd]
[  ][  ][  ][  ][B ][  ][  ][Hr][  ][Wu][Hl][  ][  ][  ][  ][B ]
[Hl][  ][  ][  ][  ][  ][  ][Wl][Wl][  ][  ][  ][  ][B ][B ][  ]
