[  ][Hu][  ][  ][  ][Hr][  ][  ][  ][  ][  ][  ][Hd][  ][  ][  ]
[B ][  ][  ][  ][  ][  ][  ][  ][  ][  ][  ][Hr][  ][B ][  ][Hu]
[  ][Wu][  ][  ][  ][  ][  ][  ][  ][  ][  ][  ][  ][D ][  ][  ]
[  ][  ][Hr][  ][  ][  ][  ][B ][  ][  ][  ][  ][  ][  ][  ][  ]
[  ][B ][  ][  ][  ][  ][  ][  ][Hd][  ][Hr][Wl][  ][  ][  ][Hr]
[  ][B ][  ][  ][  ][  ][  ][  ][  ][  ][  ][  ][  ][Wu][  ][  ]
[Wu][  ][  ][  ][  ][  ][  ][  ][Wu][Ex][  ][  ][  ][  ][  ][Wd]
[  ][Hd][  ][  ][  ][  ][B ][  ][  ][  ][  ][  ][  ][  ][Wr][  ]
[  ][  ][  ][  ][Wu][Hr][  ][  ][  ][  ][  ][  ][  ][  ][  ][  ]
