[  ][B ][  ][B ][  ][  ][  ][  ][  ][Hr][  ][  ][  ][  ][  ][  ]
[B ][  ][Wu][  ][  ][  ][  ][  ][  ][  ][  ][  ][  ][  ][  ][  ]
[  ][Wu][  ][  ][  ][  ][  ][  ][  ][  ][  ][  ][  ][D ][  ][Hu]
[  ][  ][  ][B ][  ][  ][  ][  ][  ][  ][  ][  ][  ][Hr][  ][  ]
[  ][  ][  ][  ][  ][  ][  ][  ][  ][  ][  ][  ][  ][  ][  ][Hr]
[  ][  ][  ][  ][  ][  ][  ][  ][  ][  ][  ][  ][  ][  ][  ][  ]
[  ][  ][  ][  ][  ][  ][  ][B ][  ][Ex][  ][  ][  ][  ][  ][  ]
[  ][  ][  ][  ][  ][  ][  ][B ][  ][  ][  ][  ][  ][  ][Hu][  ]
[  ][  ][  ][  ][Wu][  ][  ][Hl][  ][  ][  ][  ][  ][  ][  ][  ]
