[  ][  ][  ][B ][Wl][Wr][  ][  ][Wu][  ][  ][  ][B ][  ][  ][  ]
[B ][  ][Wu][  ][  ][B ][  ][  ][Hd][  ][  ][  ][  ][Hl][  ][  ]
[Wl][  ][  ][Wl][  ][  ][B ][  ][  ][  ][B ][  ][  ][D ][  ][Hd]
[  ][Wd][  ][B ][  ][  ][Wr][B ][  ][  ][  ][Wu][  ][Hu][  ][  ]
[  ][  ][  ][Hr][  ][  ][B ][  ][  ][  ][Wu][Wu][  ][  ][  ][  ]
[  ][  ][B ][  ][  ][  ][Wu][  ][  ][  ][  ][Wr][  ][  ][Wl][  ]
[  ][B ][  ][  ][Hd][B ][  ][B ][  ][Ex][  ][  ][  ][Wd][  ][  ]
[  ][  ][Wl][Wr][  ][  ][Hl][B ][  ][Wd][  ][  ][  ][  ][B ][Wu]
[  ][  ][Wu][  ][  ][B ][  ][Hl][  ][  ][  ][  ][  ][  ][B ][  ]
