[  ][Hu][  ][B ][  ][Hl][  ][  ][  ][  ][B ][  ][Hd][Wd][  ][  ]
[B ][Hu][Hd][  ][  ][  ][Wu][  ][  ][  ][  ][Hl][Wd][  ][  ][  ]
[  ][Wu][  ][  ][B ][  ][Hd][  ][Hl][  ][B ][  ][  ][D ][  ][Hu]
[Hd][  ][  ][Wr][B ][B ][  ][B ][  ][  ][  ][  ][  ][  ][  ][  ]
[Wr][B ][B ][  ][  ][  ][  ][  ][  ][Hl][B ][Wl][  ][  ][  ][Hu]
[  ][B ][  ][  ][  ][  ][Hd][  ][  ][  ][  ][  ][  ][  ][  ][B ]
[B ][Wd][  ][  ][Wu][  ][  ][  ][Wu][Ex][B ][  ][B ][B ][  ][Wd]
[  ][Hu][  ][  ][  ][  ][B ][Hr][B ][  ][Wu][  ][Hd][  ][Wr][  ]
[  ][Wu][  ][  ][Wu][Hr][B ][  ][  ][Wl][  ][Wr][Wr][  ][  ][  ]
