[  ][B ][  ][B ][  ][  ][  ][  ][B ][  ][Hu][  ][  ][Wd][  ][  ]
[  ][  ][  ][  ][  ][  ][  ][Wd][  ][  ][B ][  ][  ][  ][  ][  ]
[  ][Wd][  ][  ][  ][  ][Wd][  ][  ][B ][  ][  ][  ][D ][  ][B ]
[  ][B ][  ][  ][  ][  ][  ][B ][  ][  ][Wu][Hr][  ][  ][  ][  ]
[  ][  ][  ][  ][  ][Wu][Hd][  ][  ][B ][  ][Wl][  ][  ][  ][Hr]
[  ][B ][  ][  ][  ][B ][  ][  ][  ][  ][  ][  ][  ][  ][  ][  ]
[  ][  ][Hu][  ][  ][Wu][  ][  ][Wu][Ex][  ][  ][B ][  ][Hd][Wd]
[  ][  ][  ][  ][Wl][  ][B ][Wr][Wu][  ][  ][  ][  ][  ][Wr][  ]
[  ][Wu][  ][  ][Wu][Hr][  ][  ][Wl][  ][  ][  ][  ][  ][Wu][  ]
