[D ][  ][  ][  ][B ][  ][Hu][Hu]
[  ][  ][Hd][  ][  ][  ][  ][  ]
[  ][  ][  ][  ][  ][Hl][  ][B ]
[  ][  ][  ][  ][  ][  ][B ][  ]
[  ][  ][  ][  ][Wr][Hu][  ][  ]
[Wl][Hr][  ][  ][B ][B ][  ][  ]
[  ][  ][  ][  ][  ][  ][B ][  ]
[  ][B ][  ][  ][  ][  ][B ][Ex]
