[D ][Wu][  ][  ][  ][  ][B ][  ]
[Wr][Wd][Wu][  ][  ][  ][Wu][  ]
[  ][  ][  ][  ][  ][  ][  ][  ]
[  ][  ][Hu][  ][  ][  ][  ][  ]
[  ][  ][Wu][B ][  ][  ][  ][  ]
[  ][  ][  ][  ][  ][  ][  ][Hd]
[  ][  ][  ][  ][  ][Wu][  ][  ]
[  ][  ][  ][  ][  ][  ][  ][Ex]
