[D ][  ][  ][  ][B ][Hu][  ][  ]
[  ][B ][  ][  ][  ][  ][Hu][  ]
[Wr][  ][  ][  ][  ][  ][  ][  ]
[  ][  ][  ][  ][  ][  ][B ][  ]
[Hu][  ][Hu][  ][  ][Hu][  ][  ]
[  ][  ][  ][  ][B ][  ][  ][  ]
[  ][  ][  ][  ][  ][  ][  ][  ]
[  ][  ][  ][  ][  ][  ][  ][Ex]
