[D ][  ][  ][  ][Wu][  ][  ][Wd]
[  ][  ][  ][Hu][  ][  ][Hr][  ]
[  ][Hu][  ][Wu][  ][  ][  ][  ]
[  ][B ][  ][  ][  ][  ][  ][  ]
[  ][  ][  ][  ][  ][B ][Wd][  ]
[  ][B ][  ][  ][  ][  ][  ][B ]
[  ][  ][  ][  ][  ][  ][  ][  ]
[  ][  ][  ][  ][  ][  ][  ][Ex]
