[D ][  ][  ][  ][  ][B ][  ][  ]
[  ][  ][  ][  ][  ][  ][  ][Wr]
[  ][  ][  ][  ][  ][  ][  ][  ]
[Wu][  ][Hd][  ][  ][  ][  ][  ]
[B ][  ][  ][Hu][  ][  ][Hr][  ]
[  ][Hr][  ][  ][  ][  ][  ][  ]
[  ][  ][  ][  ][  ][  ][  ][  ]
[  ][  ][  ][Wd][  ][B ][  ][Ex]
