[D ][  ][  ][  ][  ][B ][  ][  ]
[  ][  ][Hr][  ][  ][  ][  ][  ]
[  ][  ][  ][  ][  ][B ][  ][  ]
[  ][  ][  ][  ][  ][  ][B ][B ]
[  ][  ][  ][  ][  ][  ][Wr][  ]
[  ][Hr][B ][  ][B ][  ][  ][  ]
[  ][  ][  ][  ][  ][  ][  ][Wr]
[  ][  ][  ][Hr][  ][  ][  ][Ex]
