[D ][  ][  ][  ][B ][Wu][  ][Hu]
[  ][  ][  ][  ][  ][  ][  ][Hu]
[Wr][  ][Wl][  ][  ][  ][  ][  ]
[  ][  ][Wr][B ][  ][Wr][B ][  ]
[  ][  ][  ][  ][  ][Hu][  ][  ]
[  ][Hl][  ][B ][B ][B ][  ][  ]
[  ][B ][  ][  ][  ][Hl][  ][Hr]
[  ][  ][  ][  ][Wl][  ][  ][Ex]
