[D ][  ][  ][B ][  ][  ][Hr][  ]
[  ][Wl][  ][  ][B ][  ][  ][Wl]
[  ][  ][  ][  ][B ][  ][  ][  ]
[  ][  ][  ][  ][  ][Wl][Wu][  ]
[  ][  ][  ][  ][Wu][  ][  ][  ]
[  ][  ][Hd][Hl][B ][  ][  ][  ]
[Wl][  ][Wl][  ][Wd][  ][  ][  ]
[B ][B ][  ][  ][Hd][  ][  ][Ex]
