[D ][  ][  ][B ][  ][  ][  ][Wr]
[  ][  ][  ][  ][  ][  ][  ][Wl]
[  ][  ][  ][  ][B ][Wl][  ][  ]
[Hr][  ][  ][  ][  ][  ][Wu][  ]
[  ][  ][  ][  ][  ][  ][  ][B ]
[B ][  ][  ][  ][B ][  ][  ][  ]
[Wl][  ][Wl][  ][  ][  ][Hr][  ]
[  ][  ][  ][  ][Hd][  ][Wd][Ex]
