[D ][  ][  ][B ][  ][  ][  ][  ]
[  ][  ][Wu][  ][  ][  ][  ][  ]
[  ][  ][Wr][  ][  ][  ][  ][  ]
[  ][  ][  ][  ][  ][  ][Wu][  ]
[  ][  ][  ][  ][  ][  ][  ][Wr]
[  ][  ][  ][  ][B ][  ][  ][  ]
[  ][  ][  ][  ][  ][  ][Hr][  ]
[Wl][  ][  ][  ][  ][  ][Hl][Ex]
