[D ][  ][B ][  ][  ][  ][  ][  ]
[  ][  ][  ][Wu][  ][  ][  ][  ]
[  ][Hd][  ][  ][  ][Wd][  ][  ]
[Wu][  ][  ][Hl][  ][Hd][  ][  ]
[  ][  ][Wr][  ][  ][  ][  ][  ]
[  ][  ][  ][  ][B ][  ][  ][  ]
[Hl][  ][  ][  ][  ][  ][  ][  ]
[  ][  ][  ][  ][  ][  ][  ][Ex]
