[D ][  ][  ][  ][B ][  ][  ][Hu]
[  ][  ][Hd][  ][  ][  ][  ][  ]
[  ][  ][  ][  ][  ][Hl][  ][B ]
[  ][  ][  ][  ][  ][  ][B ][  ]
[  ][  ][  ][  ][B ][Hu][  ][  ]
[  ][Hr][  ][  ][B ][B ][  ][  ]
[  ][  ][Hr][  ][  ][  ][B ][  ]
[  ][  ][  ][B ][  ][  ][B ][Ex]
