[D ][  ][  ][Wl][Wr][  ][  ][Wr]
[  ][  ][  ][  ][B ][  ][  ][Wl]
[  ][  ][  ][  ][  ][  ][  ][  ]
[Wd][  ][  ][  ][  ][  ][Wl][  ]
[  ][B ][  ][  ][  ][Hr][Wr][Wl]
[  ][  ][  ][  ][B ][  ][  ][  ]
[  ][  ][Wd][  ][  ][  ][  ][  ]
[  ][  ][  ][  ][Hd][  ][  ][Ex]
