[D ][  ][  ][Hr][B ][Wu][  ][Hu]
[  ][  ][Wr][  ][  ][Wl][  ][Hu]
[Wr][  ][Wl][Hr][  ][  ][  ][  ]
[  ][  ][  ][B ][  ][  ][B ][  ]
[  ][  ][  ][  ][  ][Hu][  ][  ]
[  ][Hr][  ][  ][B ][B ][  ][  ]
[  ][Wr][  ][  ][  ][  ][  ][  ]
[  ][  ][  ][  ][Wl][  ][  ][Ex]
