[D ][  ][  ][  ][  ][B ][  ][  ]
[  ][  ][  ][  ][  ][B ][  ][  ]
[  ][  ][  ][  ][  ][B ][  ][B ]
[  ][  ][  ][  ][  ][  ][B ][B ]
[  ][  ][  ][  ][  ][  ][  ][  ]
[  ][Hr][B ][  ][B ][  ][  ][Hd]
[  ][  ][  ][  ][  ][  ][  ][Wr]
[  ][  ][  ][Wd][  ][  ][B ][Ex]
