[D ][  ][  ][  ][  ][Wu][  ][  ]
[B ][  ][  ][  ][  ][  ][  ][  ]
[  ][  ][  ][  ][B ][  ][Wl][  ]
[  ][  ][  ][B ][  ][  ][  ][  ]
[B ][Wl][  ][  ][  ][Wr][  ][  ]
[Hd][  ][  ][  ][  ][B ][  ][Hd]
[  ][  ][B ][  ][  ][  ][  ][  ]
[  ][B ][B ][  ][Wl][Hr][Wl][Ex]
