[D ][  ][Wl][  ][B ][  ][  ][Hu]
[  ][  ][Hd][B ][B ][  ][  ][  ]
[Wr][  ][  ][  ][  ][  ][  ][  ]
[  ][  ][B ][Wd][  ][  ][  ][  ]
[B ][B ][  ][  ][  ][Hu][  ][  ]
[  ][  ][  ][  ][  ][B ][  ][  ]
[  ][  ][  ][  ][  ][  ][B ][  ]
[  ][  ][  ][  ][Wl][  ][  ][Ex]
