[D ][  ][Wl][  ][B ][  ][  ][  ]
[  ][  ][Hd][  ][B ][  ][  ][  ]
[Wr][  ][  ][  ][  ][  ][  ][  ]
[  ][  ][  ][Wd][  ][  ][  ][  ]
[B ][B ][  ][  ][  ][Hu][  ][  ]
[  ][  ][  ][  ][B ][B ][  ][  ]
[  ][  ][  ][  ][  ][  ][Wd][  ]
[  ][Hl][  ][  ][  ][  ][  ][Ex]
