[D ][  ][  ][  ][  ][Wu][  ][B ]
[  ][  ][  ][  ][  ][  ][Wl][  ]
[  ][  ][  ][  ][B ][  ][Wl][  ]
[  ][  ][  ][B ][Hl][  ][  ][  ]
[B ][Wl][  ][  ][Wl][Wr][  ][  ]
[Hd][  ][  ][  ][  ][B ][  ][  ]
[  ][  ][B ][  ][  ][  ][  ][  ]
[  ][B ][B ][  ][Wl][Hr][Wl][Ex]
