[D ][  ][  ][  ][B ][Hu][  ][  ]
[  ][  ][  ][  ][Wu][B ][Hu][  ]
[Wr][  ][Wr][  ][Wd][  ][  ][  ]
[Wd][  ][  ][  ][  ][  ][  ][Wu]
[Hu][  ][Hu][  ][  ][Hu][  ][  ]
[  ][  ][  ][  ][B ][B ][  ][B ]
[  ][  ][  ][  ][  ][  ][  ][  ]
[  ][B ][  ][  ][  ][  ][  ][Ex]
