[D ][  ][  ][  ][  ][  ][B ][  ]
[Wr][Wd][Wu][  ][Hr][Wd][B ][  ]
[  ][  ][  ][  ][  ][  ][  ][  ]
[Wd][Hd][  ][  ][Wu][  ][  ][  ]
[  ][  ][Wu][  ][  ][  ][Wd][  ]
[  ][  ][Hr][  ][  ][  ][  ][  ]
[  ][  ][  ][  ][  ][  ][  ][  ]
[  ][  ][Wu][  ][  ][  ][  ][Ex]
