[D ][  ][  ][  ][  ][  ][  ][Hu]
[  ][  ][Hr][  ][  ][  ][  ][  ]
[  ][  ][  ][  ][  ][  ][  ][  ]
[  ][  ][  ][  ][  ][  ][B ][Hu]
[  ][  ][  ][  ][  ][  ][  ][  ]
[  ][Hr][  ][  ][B ][  ][  ][  ]
[  ][  ][Hr][  ][  ][  ][B ][  ]
[  ][  ][  ][B ][Wl][  ][  ][Ex]
