[D ][  ][  ][  ][  ][  ][Hu][  ]
[  ][Wl][  ][  ][B ][  ][  ][  ]
[Hu][  ][  ][  ][  ][  ][  ][  ]
[Hr][B ][Hr][  ][  ][  ][  ][  ]
[  ][  ][  ][  ][  ][Wr][  ][  ]
[  ][  ][  ][  ][  ][B ][  ][  ]
[  ][  ][  ][  ][  ][  ][  ][  ]
[Wu][  ][  ][  ][  ][  ][  ][Ex]
