[D ][Hr][  ][  ][B ][B ][  ][  ]
[  ][  ][  ][B ][  ][  ][Hu][  ]
[  ][  ][  ][  ][Hd][  ][  ][  ]
[B ][  ][  ][  ][  ][  ][B ][  ]
[  ][  ][B ][  ][  ][Hu][  ][B ]
[  ][  ][  ][  ][  ][Hr][  ][  ]
[  ][  ][Hu][  ][  ][  ][  ][  ]
[  ][  ][  ][  ][  ][  ][  ][Ex]
