[D ][  ][  ][Wl][  ][  ][  ][Wr]
[  ][  ][  ][  ][B ][  ][  ][  ]
[  ][  ][B ][  ][  ][  ][  ][  ]
[Wd][  ][  ][  ][  ][  ][Wl][  ]
[  ][B ][  ][  ][  ][Hr][B ][Wl]
[  ][  ][  ][  ][B ][  ][  ][  ]
[  ][  ][Wd][  ][  ][  ][  ][  ]
[  ][  ][  ][  ][Hd][  ][  ][Ex]
