[D ][  ][  ][  ][  ][  ][B ][  ]
[Wr][  ][Wu][  ][  ][  ][  ][  ]
[  ][  ][  ][  ][  ][  ][  ][  ]
[  ][  ][  ][  ][Wd][  ][  ][  ]
[  ][  ][  ][  ][  ][Wl][  ][  ]
[Hu][  ][Hr][  ][  ][  ][  ][  ]
[  ][  ][  ][Wl][Hl][Wu][  ][  ]
[Hu][  ][Wu][Wr][  ][  ][  ][Ex]
