[D ][  ][  ][  ][  ][B ][  ][  ]
[  ][  ][Hr][  ][  ][  ][  ][  ]
[  ][B ][  ][  ][  ][  ][  ][  ]
[  ][  ][  ][  ][  ][  ][B ][  ]
[  ][  ][  ][  ][  ][  ][  ][  ]
[  ][Hr][  ][  ][B ][  ][Hu][  ]
[  ][  ][  ][  ][  ][  ][  ][Wr]
[  ][  ][  ][Hr][  ][Wd][  ][Ex]
