[D ][  ][  ][  ][B ][Hu][  ][Hu]
[  ][  ][Hd][Hr][  ][  ][  ][Hu]
[Wr][  ][  ][  ][  ][  ][  ][  ]
[  ][  ][  ][  ][  ][  ][  ][  ]
[  ][B ][  ][  ][  ][Hu][  ][  ]
[  ][Hr][  ][  ][B ][B ][  ][  ]
[  ][  ][  ][  ][  ][  ][B ][  ]
[  ][  ][  ][  ][  ][  ][  ][Ex]
