[D ][  ][  ][  ][B ][Hu][  ][  ]
[  ][  ][  ][  ][Wu][B ][Hu][  ]
[  ][  ][  ][  ][Wd][  ][  ][  ]
[Wd][  ][  ][  ][Wr][  ][  ][Wu]
[Hu][  ][Hu][Wl][  ][Hu][  ][  ]
[  ][  ][  ][  ][  ][B ][  ][B ]
[  ][  ][  ][  ][  ][  ][  ][  ]
[  ][B ][  ][  ][  ][  ][  ][Ex]
