[D ][  ][  ][  ][  ][  ][  ][  ]
[  ][  ][Wu][  ][  ][  ][  ][  ]
[  ][  ][  ][  ][B ][  ][  ][  ]
[Hl][  ][  ][  ][  ][  ][  ][  ]
[  ][Wu][  ][  ][  ][  ][  ][  ]
[B ][  ][  ][  ][  ][  ][B ][  ]
[Wd][  ][  ][  ][  ][  ][Wl][  ]
[  ][  ][Wu][  ][  ][  ][  ][Ex]
