[D ][  ][  ][Wl][  ][  ][  ][Wr]
[  ][  ][  ][  ][  ][  ][  ][Wl]
[Wr][  ][  ][  ][  ][  ][  ][  ]
[Hr][  ][  ][  ][  ][  ][Wl][  ]
[  ][  ][  ][  ][  ][  ][  ][B ]
[  ][  ][  ][  ][B ][  ][  ][  ]
[Wu][  ][Wd][  ][  ][  ][Hr][  ]
[  ][  ][  ][  ][Hd][  ][  ][Ex]
