[D ][Wu][  ][  ][  ][  ][B ][  ]
[  ][Wd][Wu][  ][  ][  ][Wu][Wl]
[  ][  ][Wl][  ][  ][  ][  ][  ]
[  ][  ][Hd][  ][  ][  ][  ][  ]
[  ][  ][Wu][B ][Wl][  ][  ][  ]
[  ][  ][  ][  ][  ][  ][  ][  ]
[  ][  ][  ][  ][  ][Wu][  ][  ]
[  ][  ][  ][  ][  ][  ][  ][Ex]
