[D ][  ][  ][  ][  ][B ][  ][  ]
[  ][  ][  ][  ][  ][  ][  ][  ]
[  ][  ][Wd][  ][  ][B ][  ][  ]
[  ][Hu][  ][Wu][  ][  ][B ][B ]
[  ][  ][  ][  ][  ][  ][  ][  ]
[  ][Hr][B ][Hu][B ][  ][  ][  ]
[  ][  ][Hr][  ][  ][  ][B ][  ]
[  ][  ][  ][  ][  ][  ][Wl][Ex]
