[D ][  ][  ][  ][  ][  ][  ][  ]
[  ][  ][Wu][  ][  ][  ][Hu][Wl]
[  ][  ][  ][  ][B ][  ][  ][  ]
[  ][  ][  ][  ][  ][  ][Wu][  ]
[  ][  ][  ][  ][  ][Hu][  ][B ]
[  ][  ][  ][  ][B ][  ][  ][  ]
[  ][  ][Wl][  ][  ][  ][  ][  ]
[Wl][  ][  ][  ][  ][  ][  ][Ex]
