[D ][  ][  ][  ][B ][Wu][  ][B ]
[  ][  ][  ][  ][  ][  ][  ][  ]
[B ][  ][B ][  ][  ][  ][  ][Wl]
[  ][  ][  ][  ][  ][  ][B ][Hl]
[  ][  ][  ][B ][  ][Hu][  ][  ]
[  ][B ][Hr][  ][B ][  ][  ][  ]
[  ][  ][Hd][  ][  ][Hl][Wl][Hr]
[  ][  ][Wl][  ][  ][Wu][  ][Ex]
