[D ][  ][  ][  ][  ][Wd][  ][  ]
[  ][  ][  ][  ][  ][  ][Hr][  ]
[  ][  ][  ][  ][  ][  ][  ][Hd]
[  ][Wd][  ][  ][  ][  ][  ][  ]
[  ][Hl][B ][  ][  ][Hu][  ][  ]
[Wl][Hu][  ][  ][  ][  ][  ][  ]
[  ][  ][  ][  ][  ][  ][  ][  ]
[  ][Hu][  ][  ][  ][  ][  ][Ex]
