[D ][  ][  ][  ][  ][  ][  ][  ]
[B ][  ][  ][  ][  ][  ][  ][  ]
[  ][  ][  ][  ][Hl][  ][  ][  ]
[  ][  ][  ][B ][  ][  ][Wd][Wl]
[  ][Wu][  ][  ][  ][  ][  ][  ]
[B ][Hl][  ][  ][  ][  ][B ][  ]
[  ][  ][  ][Hu][  ][  ][B ][  ]
[  ][  ][  ][  ][  ][  ][  ][Ex]
