[D ][  ][  ][  ][  ][B ][  ][  ]
[  ][  ][  ][  ][  ][  ][  ][  ]
[  ][  ][Hr][  ][Hd][B ][  ][B ]
[  ][  ][  ][  ][  ][  ][B ][B ]
[B ][  ][  ][  ][  ][  ][Wr][  ]
[  ][  ][B ][  ][  ][  ][Hu][  ]
[  ][  ][  ][  ][  ][  ][  ][  ]
[  ][  ][  ][Wd][  ][B ][  ][Ex]
