[D ][  ][  ][  ][  ][  ][  ][  ]
[  ][B ][Hr][  ][  ][  ][  ][  ]
[Hu][B ][  ][  ][B ][  ][  ][  ]
[  ][B ][  ][  ][  ][  ][B ][  ]
[B ][  ][  ][  ][  ][  ][  ][  ]
[  ][  ][  ][  ][B ][  ][  ][  ]
[  ][Hu][Wl][  ][Wu][  ][Wr][Wr]
[  ][Wl][  ][Hr][B ][  ][Wu][Ex]
