[D ][  ][Wl][  ][  ][  ][  ][  ]
[  ][  ][Hd][  ][B ][  ][  ][  ]
[  ][  ][  ][  ][  ][  ][  ][Hr]
[  ][  ][  ][Wd][  ][  ][  ][  ]
[B ][  ][  ][  ][  ][  ][  ][  ]
[  ][  ][  ][  ][B ][B ][  ][  ]
[  ][  ][  ][  ][  ][  ][B ][  ]
[Wd][B ][  ][  ][B ][  ][  ][Ex]
