[D ][  ][  ][  ][  ][  ][  ][  ][  ][  ][  ][  ][  ][  ][  ][  ]
[  ][  ][Wu][  ][  ][  ][  ][  ][  ][  ][  ][  ][  ][  ][  ][  ]
[  ][  ][  ][  ][  ][  ][  ][  ][B ][B ][  ][  ][  ][  ][Hr][  ]
[  ][B ][  ][  ][  ][  ][  ][  ][B ][  ][  ][  ][  ][B ][  ][B ]
[  ][  ][  ][  ][B ][  ][  ][  ][  ][  ][  ][  ][  ][  ][  ][  ]
[  ][  ][B ][  ][B ][  ][  ][  ][  ][  ][  ][  ][  ][  ][  ][  ]
[Wu][  ][  ][  ][  ][  ][  ][Hr][  ][  ][  ][  ][  ][  ][B ][  ]
[Wu][  ][  ][  ][  ][  ][  ][  ][B ][  ][  ][Wd][  ][  ][  ][Hu]
[  ][  ][  ][Wl][  ][  ][B ][  ][  ][  ][  ][  ][  ][Hd][  ][Ex]
