[D ][  ][  ][  ][  ][  ][  ][  ][  ][  ][  ][  ][  ][  ][  ][  ]
[  ][  ][Wu][  ][  ][  ][  ][Hu][  ][  ][  ][Wu][  ][  ][  ][  ]
[  ][  ][B ][  ][Hl][B ][  ][B ][B ][B ][  ][  ][Hr][  ][  ][  ]
[  ][  ][  ][  ][  ][  ][  ][  ][  ][  ][  ][  ][  ][B ][  ][Hu]
[  ][Hr][  ][  ][Wr][  ][  ][  ][  ][  ][B ][  ][  ][  ][  ][B ]
[  ][  ][Hl][  ][B ][  ][Wl][  ][  ][  ][Wr][  ][  ][  ][  ][  ]
[B ][  ][  ][  ][B ][  ][  ][  ][  ][  ][B ][  ][  ][  ][B ][  ]
[B ][  ][Wl][  ][B ][  ][Wu][  ][B ][  ][  ][  ][  ][  ][  ][  ]
[  ][Wl][Wr][  ][  ][  ][  ][  ][  ][  ][B ][B ][  ][Hd][  ][Ex]
