[D ][  ][  ][  ][  ][  ][  ][  ][  ][  ][  ][  ][  ][  ][  ][  ]
[  ][  ][  ][  ][  ][  ][  ][  ][  ][  ][Wd][Wu][  ][  ][  ][  ]
[  ][  ][B ][  ][Hl][B ][  ][  ][B ][  ][  ][  ][  ][  ][  ][  ]
[  ][B ][  ][  ][  ][  ][  ][  ][  ][  ][  ][  ][  ][  ][  ][  ]
[  ][Hr][  ][  ][B ][  ][  ][  ][  ][  ][  ][  ][  ][Hr][  ][  ]
[  ][  ][B ][  ][B ][Hd][  ][  ][  ][  ][  ][  ][  ][  ][  ][  ]
[Wu][  ][  ][  ][  ][  ][  ][  ][  ][  ][  ][  ][  ][  ][  ][  ]
[Wu][  ][Wl][  ][B ][  ][  ][  ][B ][  ][  ][  ][  ][  ][  ][  ]
[  ][  ][  ][  ][  ][  ][  ][  ][Hr][  ][Wu][Hd][  ][Hd][  ][Ex]
