[D ][  ][  ][  ][  ][  ][  ][  ][  ][  ][  ][  ][Wr][  ][Wu][  ]
[  ][  ][  ][  ][  ][  ][  ][  ][  ][  ][  ][Wu][  ][  ][  ][  ]
[  ][  ][B ][  ][Hl][  ][  ][B ][B ][  ][  ][B ][  ][  ][  ][  ]
[Wu][  ][  ][Wd][  ][  ][  ][  ][  ][  ][  ][  ][  ][Wd][  ][  ]
[  ][  ][  ][  ][  ][  ][  ][  ][  ][  ][Hl][  ][Hr][Hr][Wu][  ]
[  ][  ][  ][  ][  ][Hd][  ][  ][Wr][  ][  ][  ][  ][  ][  ][  ]
[Wu][  ][  ][  ][  ][  ][  ][  ][  ][  ][  ][  ][  ][  ][  ][  ]
[  ][  ][Wl][  ][Hl][  ][  ][  ][B ][  ][  ][  ][Wl][  ][  ][  ]
[  ][  ][B ][  ][  ][  ][  ][  ][  ][  ][Wu][  ][  ][Hd][  ][Ex]
