[D ][  ][Hu][  ][  ][  ][  ][  ][  ][  ][  ][  ][  ][  ][  ][  ]
[  ][  ][  ][  ][  ][B ][  ][  ][  ][B ][  ][  ][  ][Hr][  ][  ]
[  ][  ][  ][  ][B ][  ][  ][  ][  ][  ][  ][  ][  ][  ][  ][  ]
[  ][  ][  ][  ][  ][  ][  ][  ][  ][  ][  ][  ][Wr][Wd][  ][  ]
[  ][Hr][  ][Wd][Hr][  ][  ][  ][  ][B ][  ][B ][Hr][  ][  ][  ]
[  ][  ][  ][  ][  ][  ][  ][  ][  ][  ][  ][  ][  ][  ][  ][  ]
[  ][  ][  ][  ][  ][  ][  ][  ][  ][Hl][  ][  ][B ][  ][  ][  ]
[  ][  ][B ][  ][B ][  ][  ][  ][  ][  ][  ][Hu][Wl][B ][  ][  ]
[  ][  ][B ][  ][  ][  ][Wd][  ][  ][  ][  ][  ][  ][  ][  ][Ex]
