[D ][  ][Hd][  ][  ][  ][  ][  ][  ][  ][  ][  ][Wd][  ][  ][  ]
[  ][  ][B ][  ][  ][  ][Hr][  ][  ][B ][  ][  ][  ][  ][  ][  ]
[  ][  ][Wr][  ][  ][  ][  ][  ][  ][  ][Wr][  ][Wl][  ][  ][  ]
[B ][  ][  ][Wu][  ][  ][  ][  ][  ][  ][  ][  ][Hu][  ][  ][  ]
[  ][  ][  ][  ][  ][Wl][  ][  ][  ][  ][  ][  ][  ][  ][Hu][  ]
[  ][  ][  ][  ][B ][  ][  ][Hl][Hl][  ][  ][  ][  ][  ][  ][  ]
[  ][Wr][  ][  ][  ][  ][  ][  ][  ][  ][  ][Wu][Wd][  ][  ][  ]
[  ][  ][  ][  ][  ][B ][  ][Wr][  ][  ][  ][  ][  ][B ][  ][Wl]
[  ][  ][Wd][  ][  ][B ][  ][  ][  ][  ][  ][  ][  ][  ][  ][Ex]
