[D ][  ][  ][  ][  ][  ][  ][  ][  ][  ][  ][  ][  ][  ][  ][  ]
[  ][  ][Wu][  ][  ][  ][  ][  ][  ][  ][  ][  ][  ][  ][  ][  ]
[  ][  ][  ][Wr][  ][  ][  ][B ][  ][B ][  ][  ][  ][  ][Hr][  ]
[  ][B ][  ][  ][  ][  ][  ][  ][B ][  ][  ][  ][  ][B ][  ][  ]
[  ][  ][  ][  ][B ][  ][  ][  ][  ][  ][  ][  ][  ][  ][  ][  ]
[  ][  ][B ][  ][  ][  ][Wl][  ][  ][  ][  ][  ][B ][  ][  ][  ]
[Wu][  ][  ][  ][  ][  ][  ][Hr][  ][  ][  ][  ][  ][  ][B ][  ]
[Wu][  ][  ][  ][  ][  ][  ][  ][B ][  ][  ][  ][  ][  ][  ][Hu]
[  ][  ][  ][  ][  ][  ][  ][  ][  ][  ][  ][Hl][  ][  ][  ][Ex]
