[D ][  ][  ][B ][  ][  ][  ][  ][  ][  ][  ][  ][  ][  ][  ][  ]
[  ][  ][  ][  ][  ][  ][  ][  ][  ][B ][  ][Wu][  ][  ][  ][  ]
[  ][  ][  ][  ][  ][B ][  ][  ][B ][B ][B ][  ][B ][Wu][  ][  ]
[  ][  ][  ][  ][  ][  ][  ][B ][  ][  ][  ][  ][  ][  ][  ][  ]
[  ][Hr][Hr][  ][B ][  ][  ][Hu][  ][  ][  ][  ][  ][  ][Wu][  ]
[  ][  ][B ][  ][B ][Hd][  ][  ][Hu][  ][  ][  ][Hl][  ][  ][  ]
[Wu][  ][  ][  ][  ][  ][  ][  ][  ][Wr][  ][  ][  ][  ][  ][  ]
[B ][  ][  ][  ][B ][  ][  ][B ][B ][  ][  ][  ][  ][  ][  ][  ]
[  ][  ][  ][  ][  ][  ][  ][  ][  ][B ][Wu][Hd][  ][  ][Wr][Ex]
