[D ][B ][  ][  ][  ][  ][  ][  ][  ][  ][  ][  ][  ][  ][Wu][  ]
[  ][  ][Hu][  ][  ][  ][  ][  ][  ][  ][Wd][Wu][  ][  ][  ][  ]
[  ][  ][B ][  ][Hl][  ][  ][  ][B ][  ][  ][  ][  ][  ][  ][  ]
[Wu][  ][  ][  ][  ][  ][  ][  ][  ][  ][  ][  ][  ][Wd][  ][  ]
[Wd][Hr][  ][  ][  ][  ][  ][  ][  ][  ][Hl][  ][B ][Hr][  ][Wu]
[  ][  ][  ][  ][  ][  ][  ][  ][  ][  ][  ][  ][  ][  ][  ][  ]
[Wu][  ][  ][  ][  ][  ][  ][  ][  ][  ][  ][  ][  ][  ][  ][  ]
[  ][  ][Wl][  ][  ][  ][  ][  ][Wu][  ][  ][  ][Wl][B ][  ][  ]
[  ][  ][  ][  ][  ][  ][  ][  ][  ][  ][  ][  ][  ][Hd][  ][Ex]
