[D ][  ][  ][  ][  ][B ][  ][  ][  ][  ][  ][B ][  ][  ][  ][  ]
[Wd][  ][  ][  ][  ][  ][  ][  ][  ][B ][  ][  ][  ][Hu][  ][  ]
[  ][  ][  ][  ][  ][B ][  ][  ][  ][  ][  ][  ][  ][B ][  ][  ]
[  ][  ][  ][Hu][  ][  ][  ][  ][  ][Hr][  ][  ][  ][  ][  ][  ]
[  ][  ][  ][  ][Hr][  ][  ][  ][  ][  ][  ][  ][Hr][  ][  ][  ]
[  ][  ][  ][B ][  ][  ][  ][  ][  ][  ][  ][  ][  ][  ][  ][  ]
[  ][  ][  ][  ][  ][  ][  ][  ][  ][Hl][  ][  ][B ][  ][  ][  ]
[  ][  ][B ][  ][  ][  ][  ][  ][  ][  ][  ][Hu][  ][B ][  ][  ]
[  ][  ][B ][  ][  ][  ][  ][  ][  ][  ][  ][  ][  ][Wd][  ][Ex]
