[D ][  ][Hd][Wr][  ][  ][  ][B ][  ][  ][  ][  ][Wl][  ][  ][  ]
[  ][  ][B ][  ][  ][  ][Wu][  ][  ][  ][  ][  ][  ][  ][  ][  ]
[  ][  ][  ][  ][  ][  ][  ][  ][  ][Hl][  ][  ][  ][Wu][  ][B ]
[B ][  ][  ][  ][  ][B ][  ][  ][  ][B ][  ][Hd][  ][  ][  ][  ]
[Hu][  ][  ][  ][  ][B ][  ][  ][B ][  ][Wu][  ][  ][  ][  ][B ]
[  ][  ][  ][  ][Wl][  ][  ][  ][  ][  ][  ][  ][  ][  ][  ][  ]
[  ][  ][  ][  ][  ][  ][  ][  ][  ][  ][  ][Wu][  ][  ][  ][  ]
[  ][  ][Hd][  ][  ][B ][  ][Wr][  ][Wu][  ][  ][  ][B ][  ][  ]
[  ][  ][  ][  ][  ][  ][  ][  ][B ][  ][  ][  ][  ][  ][  ][Ex]
