[D ][  ][  ][  ][Wd][  ][  ][  ][  ][  ][  ][  ][  ][  ][Wu][  ]
[  ][  ][  ][  ][  ][  ][  ][  ][  ][  ][Wd][Wu][  ][  ][  ][  ]
[  ][  ][B ][  ][Hl][  ][  ][  ][B ][  ][  ][B ][  ][  ][  ][  ]
[Wu][  ][  ][Wd][  ][  ][  ][  ][  ][  ][  ][  ][  ][Wd][  ][  ]
[  ][Hr][  ][  ][  ][  ][  ][  ][  ][  ][Hl][  ][Hr][Hr][  ][  ]
[  ][  ][  ][  ][  ][Hd][  ][  ][  ][  ][  ][  ][  ][  ][  ][  ]
[  ][  ][  ][  ][  ][  ][  ][  ][  ][  ][  ][  ][  ][  ][  ][  ]
[  ][  ][Wl][  ][Hl][  ][  ][  ][B ][  ][  ][  ][Wl][  ][  ][  ]
[  ][  ][B ][  ][  ][  ][  ][  ][  ][  ][Wu][  ][  ][Hd][  ][Ex]
