[D ][  ][  ][  ][  ][  ][  ][  ][  ][  ][  ][  ][  ][  ][  ][  ]
[  ][  ][  ][  ][  ][  ][  ][  ][  ][  ][  ][Wu][  ][  ][  ][  ]
[  ][  ][B ][  ][  ][B ][  ][  ][B ][B ][B ][  ][  ][  ][  ][  ]
[  ][B ][  ][  ][  ][  ][  ][  ][  ][  ][  ][  ][  ][  ][  ][  ]
[  ][Hr][  ][  ][B ][  ][  ][Hl][  ][Hl][  ][  ][  ][  ][  ][  ]
[  ][  ][B ][  ][B ][Hd][  ][  ][  ][  ][  ][  ][B ][  ][  ][  ]
[Wu][  ][  ][  ][  ][  ][  ][  ][  ][  ][  ][  ][  ][  ][B ][  ]
[Wu][  ][Wl][  ][B ][  ][  ][  ][B ][  ][  ][  ][  ][Wr][  ][  ]
[  ][  ][  ][  ][  ][  ][  ][  ][  ][  ][Wu][Hd][  ][Hd][  ][Ex]
