[D ][  ][Hu][  ][Wd][  ][  ][  ][  ][  ][  ][  ][  ][  ][Wu][  ]
[  ][  ][  ][  ][  ][  ][  ][B ][  ][  ][Wd][Wu][  ][  ][  ][  ]
[  ][  ][B ][  ][Hl][  ][  ][  ][B ][  ][  ][B ][  ][  ][  ][  ]
[  ][  ][  ][Wd][  ][  ][  ][  ][  ][  ][  ][  ][  ][Wd][  ][  ]
[  ][Hr][  ][  ][  ][  ][  ][  ][  ][  ][Hl][  ][Hr][  ][Wu][  ]
[  ][  ][B ][  ][  ][  ][  ][  ][Wr][  ][  ][  ][  ][  ][  ][  ]
[Wu][  ][  ][  ][B ][  ][  ][  ][  ][  ][  ][  ][  ][  ][  ][  ]
[  ][  ][  ][  ][  ][  ][  ][  ][  ][  ][  ][  ][Wl][  ][  ][  ]
[  ][  ][B ][  ][  ][  ][Wr][  ][  ][  ][Wu][  ][  ][Hd][  ][Ex]
