[D ][  ][Hd][  ][  ][  ][  ][  ][  ][  ][  ][  ][Wd][  ][  ][  ]
[  ][  ][B ][  ][  ][  ][Hr][  ][  ][B ][  ][  ][  ][  ][  ][  ]
[  ][  ][Wr][  ][  ][  ][  ][  ][  ][  ][Wr][  ][  ][  ][  ][  ]
[B ][  ][  ][Wu][  ][  ][  ][  ][  ][Wu][  ][  ][Hu][  ][  ][  ]
[  ][  ][  ][  ][  ][Wl][  ][  ][  ][  ][  ][  ][  ][  ][Hu][  ]
[  ][  ][  ][  ][B ][  ][  ][  ][Hl][  ][  ][B ][  ][  ][  ][  ]
[  ][Wr][  ][  ][  ][  ][  ][  ][  ][  ][  ][Wu][Wd][  ][  ][  ]
[  ][  ][  ][  ][  ][B ][  ][Wr][  ][  ][  ][  ][  ][B ][  ][Wl]
[  ][  ][Wd][  ][  ][B ][  ][  ][  ][  ][  ][  ][  ][  ][  ][Ex]
