[D ][  ][  ][  ][B ][  ][  ][Hr]
[  ][Wu][B ][  ][Hl][  ][  ][  ]
[  ][Wl][  ][Wr][  ][  ][  ][  ]
[  ][  ][  ][  ][  ][  ][  ][  ]
[  ][  ][  ][  ][  ][B ][  ][  ]
[  ][  ][  ][  ][  ][  ][  ][  ]
[  ][B ][  ][  ][Wl][  ][Hl][  ]
[  ][  ][  ][  ][  ][  ][  ][Ex]
