[D ][  ][  ][  ][  ][  ][  ][Wr]
[Wd][  ][  ][  ][  ][  ][  ][  ]
[  ][  ][  ][Wd][Wd][  ][  ][Wd]
[  ][  ][  ][  ][Wl][  ][Hl][Hl]
[  ][  ][  ][  ][  ][B ][  ][  ]
[  ][  ][  ][  ][  ][  ][  ][B ]
[  ][  ][Hu][  ][  ][  ][  ][  ]
[  ][  ][  ][  ][  ][  ][  ][Ex]
