[D ][  ][  ][  ][  ][  ][  ][Hd]
[  ][  ][  ][  ][Hr][  ][  ][B ]
[  ][  ][  ][  ][  ][  ][B ][Wl]
[  ][  ][  ][  ][  ][  ][  ][Wu]
[  ][  ][Hd][  ][  ][  ][  ][Wu]
[Wr][Wd][  ][B ][  ][  ][  ][B ]
[  ][  ][B ][  ][  ][Wr][  ][  ]
[  ][  ][  ][Wr][  ][  ][  ][Ex]
