[D ][  ][  ][  ][  ][  ][  ][  ]
[B ][B ][  ][  ][  ][  ][Wu][Wr]
[Hl][  ][  ][  ][  ][  ][  ][  ]
[  ][  ][  ][  ][  ][  ][  ][  ]
[  ][  ][B ][Wu][  ][  ][  ][  ]
[  ][  ][  ][B ][Hu][  ][  ][  ]
[  ][  ][  ][  ][  ][  ][  ][  ]
[  ][  ][  ][  ][  ][  ][  ][Ex]
