[D ][  ][  ][Hr][  ][  ][  ][  ]
[  ][  ][  ][Hu][  ][  ][  ][  ]
[  ][Wl][  ][  ][  ][  ][  ][B ]
[  ][  ][  ][  ][  ][  ][B ][  ]
[  ][  ][  ][  ][  ][  ][  ][  ]
[  ][  ][  ][  ][  ][  ][  ][  ]
[  ][  ][Hd][B ][  ][  ][B ][  ]
[  ][B ][  ][  ][  ][  ][  ][Ex]
