[D ][  ][  ][Hr][  ][  ][  ][  ]
[  ][  ][  ][Hu][  ][  ][  ][  ]
[B ][Wl][  ][  ][  ][  ][  ][B ]
[  ][  ][  ][  ][  ][  ][  ][Hd]
[Wr][  ][  ][  ][  ][  ][Wr][  ]
[  ][  ][  ][  ][  ][  ][  ][  ]
[  ][  ][  ][  ][  ][  ][B ][  ]
[  ][  ][  ][  ][Wd][  ][  ][Ex]
