[D ][  ][Hu][  ][  ][Wl][Hr][  ]
[  ][  ][Wd][  ][  ][  ][  ][B ]
[B ][  ][  ][  ][  ][  ][  ][  ]
[  ][  ][Hd][B ][  ][  ][  ][  ]
[  ][  ][  ][  ][  ][B ][  ][  ]
[  ][  ][  ][  ][  ][B ][  ][  ]
[Wl][  ][  ][  ][  ][  ][  ][  ]
[  ][  ][  ][  ][  ][Wu][  ][Ex]
