[D ][  ][  ][  ][  ][  ][  ][  ]
[  ][  ][  ][  ][  ][  ][  ][  ]
[  ][  ][  ][Hl][  ][  ][  ][  ]
[Hu][  ][  ][B ][  ][  ][  ][  ]
[  ][  ][  ][  ][  ][  ][Wd][  ]
[  ][  ][  ][  ][  ][  ][B ][Hu]
[  ][Wr][  ][  ][  ][  ][  ][  ]
[B ][  ][  ][  ][  ][  ][  ][Ex]
