[D ][  ][  ][  ][  ][Wu][  ][  ]
[B ][  ][Hu][  ][  ][  ][  ][  ]
[Wd][  ][Wd][  ][Hl][  ][  ][Wu]
[  ][B ][  ][  ][Wu][B ][  ][  ]
[  ][  ][  ][  ][  ][B ][  ][Hl]
[  ][  ][  ][  ][  ][Wl][  ][  ]
[  ][Wd][  ][  ][  ][  ][  ][  ]
[  ][  ][Wd][  ][  ][  ][  ][Ex]
