[D ][  ][  ][  ][  ][  ][  ][  ]
[  ][Wu][  ][  ][  ][  ][B ][Wu]
[  ][  ][  ][Wu][  ][  ][  ][  ]
[  ][  ][Wu][B ][Wl][  ][B ][  ]
[  ][  ][  ][  ][  ][B ][  ][  ]
[  ][  ][  ][  ][B ][  ][  ][  ]
[B ][  ][  ][  ][  ][  ][  ][  ]
[  ][  ][  ][  ][  ][  ][  ][Ex]
