[D ][  ][Hu][B ][  ][  ][Hr][  ]
[  ][  ][Wd][  ][  ][  ][  ][  ]
[B ][  ][  ][  ][  ][Hd][  ][B ]
[  ][  ][  ][B ][  ][  ][  ][Hr]
[  ][  ][  ][  ][  ][  ][  ][Wl]
[  ][Hr][Wr][  ][  ][B ][  ][  ]
[  ][Wl][  ][  ][  ][  ][  ][Wu]
[  ][B ][B ][  ][  ][  ][  ][Ex]
