[D ][  ][  ][  ][  ][Wu][  ][  ]
[  ][  ][Hu][  ][  ][Wr][  ][  ]
[  ][  ][  ][B ][Hu][  ][  ][  ]
[B ][  ][  ][  ][  ][  ][  ][  ]
[  ][B ][B ][B ][Wu][  ][  ][  ]
[  ][  ][  ][  ][  ][  ][  ][  ]
[  ][  ][  ][  ][  ][  ][Wd][  ]
[  ][  ][  ][  ][  ][Wr][  ][Ex]
