[D ][  ][  ][Hr][  ][  ][  ][  ]
[  ][  ][  ][Hu][  ][  ][Hd][  ]
[B ][  ][  ][  ][  ][  ][  ][B ]
[  ][  ][  ][  ][  ][  ][  ][  ]
[  ][  ][  ][  ][  ][  ][  ][  ]
[Wl][  ][  ][  ][  ][  ][  ][  ]
[  ][  ][  ][B ][  ][Wl][  ][  ]
[  ][  ][  ][  ][  ][  ][  ][Ex]
