[D ][  ][  ][  ][  ][  ][  ][  ]
[  ][  ][  ][  ][  ][  ][  ][  ]
[  ][  ][  ][  ][  ][  ][  ][Wd]
[B ][  ][  ][  ][  ][  ][  ][  ]
[  ][Wl][B ][  ][  ][  ][  ][  ]
[  ][  ][  ][  ][Wl][  ][  ][  ]
[  ][  ][Hu][Hu][  ][Wr][Wd][  ]
[  ][  ][  ][  ][  ][  ][Wl][Ex]
