[D ][  ][B ][  ][  ][B ][  ][  ]
[  ][  ][Wd][  ][  ][  ][  ][  ]
[  ][  ][  ][  ][  ][  ][Wd][  ]
[  ][  ][  ][  ][  ][  ][  ][Wu]
[  ][  ][  ][B ][B ][  ][  ][  ]
[  ][  ][  ][  ][  ][  ][  ][  ]
[Wl][  ][  ][  ][  ][  ][  ][  ]
[  ][  ][  ][  ][  ][B ][  ][Ex]
