[D ][Hr][Hu][  ][Wu][Wl][  ][  ]
[  ][  ][Wd][  ][  ][  ][  ][B ]
[B ][Wl][  ][  ][  ][  ][  ][B ]
[  ][  ][  ][B ][  ][  ][  ][  ]
[  ][  ][  ][  ][  ][B ][  ][  ]
[  ][  ][  ][  ][  ][  ][  ][  ]
[  ][  ][Hd][  ][  ][  ][  ][  ]
[  ][  ][  ][  ][  ][  ][  ][Ex]
