[D ][  ][  ][  ][  ][Wu][  ][Hd]
[  ][  ][  ][  ][  ][  ][  ][  ]
[  ][B ][Wd][  ][  ][  ][  ][  ]
[Hu][B ][  ][  ][Wu][  ][  ][  ]
[  ][  ][  ][  ][  ][B ][  ][  ]
[  ][  ][Hd][  ][  ][Wl][  ][Hu]
[Hd][  ][  ][  ][  ][Wl][  ][  ]
[  ][  ][  ][  ][  ][  ][  ][Ex]
