[D ][  ][Wl][  ][  ][  ][  ][Hl]
[Wd][  ][  ][  ][  ][  ][  ][Wu]
[  ][  ][B ][  ][Wd][  ][B ][Wd]
[  ][Hr][  ][  ][Wl][  ][Hl][  ]
[  ][  ][  ][  ][  ][B ][  ][  ]
[  ][  ][  ][  ][  ][  ][  ][  ]
[  ][  ][Hu][  ][  ][  ][  ][  ]
[Hl][  ][  ][  ][  ][  ][  ][Ex]
