[D ][Hl][  ][B ][  ][  ][  ][Hd]
[  ][  ][  ][  ][  ][  ][  ][  ]
[  ][  ][Wu][  ][  ][  ][  ][Wl]
[  ][  ][  ][  ][  ][  ][  ][Wu]
[B ][  ][Hd][  ][  ][  ][  ][  ]
[Wr][Hr][  ][  ][  ][  ][  ][B ]
[Wr][Wr][  ][  ][  ][  ][  ][  ]
[  ][  ][  ][  ][  ][  ][  ][Ex]
