[D ][  ][  ][Wu][  ][  ][Wd][  ]
[  ][  ][B ][  ][  ][  ][  ][  ]
[  ][  ][  ][  ][  ][Wu][  ][Wd]
[  ][  ][  ][  ][  ][  ][  ][  ]
[  ][B ][  ][Hl][  ][Wd][  ][  ]
[  ][  ][  ][B ][  ][  ][  ][  ]
[  ][Wu][  ][Hu][  ][  ][  ][  ]
[  ][  ][  ][  ][  ][  ][  ][Ex]
