[D ][  ][Wr][  ][  ][  ][Wd][  ]
[B ][  ][  ][  ][  ][  ][  ][  ]
[  ][  ][  ][  ][  ][Wu][  ][Wd]
[  ][  ][  ][  ][  ][  ][  ][  ]
[  ][  ][  ][Hl][  ][  ][  ][  ]
[  ][  ][  ][B ][B ][  ][  ][  ]
[  ][Wu][  ][Hu][  ][  ][  ][  ]
[  ][  ][  ][  ][  ][  ][  ][Ex]
