[D ][  ][Wr][  ][  ][  ][  ][  ]
[  ][  ][  ][  ][  ][  ][  ][  ]
[B ][  ][  ][  ][  ][  ][  ][B ]
[B ][  ][B ][  ][  ][  ][Hr][  ]
[B ][  ][  ][  ][  ][Wd][Wr][  ]
[B ][  ][Hr][  ][  ][  ][  ][Wl]
[  ][  ][Wr][  ][  ][  ][  ][  ]
[  ][  ][  ][  ][  ][  ][  ][Ex]
