[D ][  ][  ][Hl][  ][  ][  ][  ]
[Wu][  ][  ][  ][  ][  ][  ][  ]
[  ][  ][  ][  ][  ][  ][  ][  ]
[  ][  ][  ][B ][  ][  ][  ][  ]
[  ][  ][  ][  ][Wl][  ][Hr][  ]
[  ][  ][  ][Hu][  ][  ][  ][  ]
[  ][  ][  ][  ][  ][B ][  ][  ]
[  ][  ][Hd][  ][  ][Wl][  ][Ex]
