[D ][  ][  ][Hd][  ][  ][Wd][  ]
[  ][  ][B ][  ][  ][  ][  ][Wu]
[  ][  ][B ][  ][  ][  ][  ][  ]
[  ][  ][  ][B ][  ][  ][  ][  ]
[  ][  ][  ][  ][  ][B ][  ][  ]
[  ][  ][  ][  ][  ][  ][  ][  ]
[  ][Wu][  ][  ][  ][Wr][  ][  ]
[  ][  ][  ][  ][  ][  ][  ][Ex]
