[D ][  ][  ][Hl][  ][  ][  ][  ]
[Wu][  ][  ][  ][  ][  ][  ][  ]
[  ][  ][  ][  ][  ][  ][  ][  ]
[  ][  ][  ][  ][  ][  ][  ][  ]
[  ][Hr][  ][  ][Wl][  ][Hr][  ]
[  ][  ][  ][Hu][Wr][  ][  ][  ]
[  ][  ][  ][  ][  ][  ][  ][  ]
[  ][  ][Hd][  ][  ][Wl][  ][Ex]
