[D ][  ][  ][Hr][  ][Hu][  ][  ]
[  ][  ][  ][Hu][  ][  ][  ][  ]
[B ][Wl][  ][  ][  ][  ][  ][  ]
[  ][  ][  ][  ][  ][  ][Wl][  ]
[  ][  ][B ][Wu][  ][B ][  ][  ]
[Wl][  ][  ][  ][  ][  ][  ][  ]
[  ][  ][  ][B ][  ][  ][  ][B ]
[  ][  ][  ][Hu][  ][  ][  ][Ex]
