[D ][  ][  ][Wu][  ][  ][  ][  ]
[B ][  ][  ][  ][  ][  ][  ][Wr]
[  ][  ][  ][  ][  ][Wu][  ][Wd]
[  ][  ][  ][  ][  ][  ][  ][  ]
[  ][  ][  ][  ][  ][  ][  ][  ]
[  ][  ][  ][  ][B ][  ][  ][  ]
[  ][  ][  ][Hu][  ][  ][Hl][  ]
[  ][  ][  ][  ][  ][  ][  ][Ex]
