[D ][  ][  ][  ][  ][  ][  ][  ]
[  ][  ][  ][  ][  ][  ][  ][Wr]
[  ][Wl][  ][  ][  ][  ][Wd][B ]
[  ][  ][  ][Hd][  ][B ][Hd][  ]
[  ][  ][  ][B ][  ][  ][  ][  ]
[  ][  ][  ][  ][  ][  ][B ][B ]
[  ][  ][  ][  ][B ][  ][  ][Wu]
[  ][  ][B ][  ][  ][  ][  ][Ex]
