[D ][  ][  ][B ][  ][  ][  ][Hd]
[  ][  ][  ][Wr][  ][  ][  ][  ]
[  ][  ][  ][  ][  ][  ][  ][  ]
[  ][  ][Hd][  ][  ][  ][  ][  ]
[B ][  ][Hd][  ][  ][  ][  ][  ]
[  ][Hr][  ][  ][  ][  ][  ][B ]
[Hl][Wr][  ][  ][  ][  ][  ][  ]
[  ][  ][  ][  ][  ][  ][  ][Ex]
