[D ][  ][  ][  ][  ][  ][  ][  ]
[  ][  ][  ][Hu][  ][  ][  ][  ]
[B ][Wl][  ][  ][  ][  ][  ][B ]
[  ][  ][  ][  ][  ][  ][  ][  ]
[  ][  ][  ][  ][  ][B ][Wr][  ]
[B ][  ][Hr][  ][  ][  ][  ][  ]
[  ][  ][Hd][B ][  ][  ][B ][  ]
[  ][  ][  ][  ][  ][  ][  ][Ex]
