[D ][  ][  ][Wl][  ][  ][  ][Hd]
[  ][  ][  ][Hd][  ][  ][  ][Wu]
[  ][  ][  ][  ][  ][  ][Wd][  ]
[  ][  ][  ][  ][Wl][  ][  ][  ]
[  ][  ][Hd][  ][  ][B ][  ][  ]
[  ][  ][  ][  ][  ][  ][  ][B ]
[Hl][Wr][  ][  ][  ][  ][  ][  ]
[  ][  ][  ][  ][  ][  ][  ][Ex]
