[D ][  ][B ][  ][  ][Wd][  ][  ]
[B ][  ][Hu][  ][  ][  ][  ][  ]
[Wd][Wl][Wd][  ][  ][  ][  ][  ]
[  ][B ][  ][  ][Wu][B ][  ][  ]
[  ][  ][  ][  ][  ][B ][  ][  ]
[  ][  ][  ][  ][  ][Wl][  ][  ]
[Hd][Wd][  ][  ][  ][  ][  ][  ]
[  ][  ][Wd][  ][  ][  ][  ][Ex]
