[D ][  ][  ][  ][  ][Wu][  ][  ]
[  ][  ][Hu][  ][  ][  ][  ][  ]
[  ][  ][  ][B ][Hu][  ][  ][Wd]
[B ][  ][  ][  ][  ][  ][  ][  ]
[B ][  ][  ][B ][Wu][  ][  ][  ]
[  ][  ][  ][  ][  ][  ][  ][  ]
[  ][  ][  ][  ][  ][  ][Wd][  ]
[  ][  ][  ][  ][  ][  ][  ][Ex]
