[D ][Hr][Hu][Hr][  ][B ][  ][  ]
[  ][  ][  ][  ][  ][  ][  ][  ]
[  ][Wl][  ][Wr][  ][  ][  ][  ]
[  ][  ][  ][  ][B ][  ][  ][  ]
[  ][  ][  ][  ][  ][B ][  ][  ]
[  ][  ][  ][  ][  ][  ][  ][  ]
[  ][  ][Hd][  ][  ][  ][Hd][  ]
[  ][  ][  ][  ][  ][  ][  ][Ex]
