[D ][  ][Hu][  ][  ][  ][Hr][  ]
[  ][  ][Wd][  ][  ][  ][  ][B ]
[B ][  ][  ][  ][  ][  ][  ][B ]
[  ][  ][Hd][B ][  ][  ][  ][Wu]
[  ][  ][  ][  ][  ][  ][  ][Wl]
[  ][  ][Wr][  ][  ][B ][  ][  ]
[Wl][Hl][  ][  ][  ][  ][  ][  ]
[  ][  ][  ][  ][  ][  ][  ][Ex]
