[D ][  ][Wr][  ][  ][  ][B ][  ]
[B ][  ][  ][  ][  ][  ][  ][  ]
[  ][  ][  ][  ][  ][Wu][  ][Wd]
[  ][  ][  ][  ][  ][  ][  ][  ]
[  ][  ][  ][  ][  ][B ][  ][  ]
[  ][B ][  ][Wl][B ][  ][  ][  ]
[  ][Wu][  ][Hu][  ][  ][  ][  ]
[  ][  ][  ][  ][  ][Wd][  ][Ex]
