[D ][  ][  ][  ][  ][  ][  ][  ]
[  ][  ][  ][  ][  ][  ][  ][  ]
[  ][  ][Wd][  ][  ][  ][  ][B ]
[Hu][  ][  ][B ][  ][  ][  ][  ]
[  ][  ][  ][  ][  ][  ][  ][  ]
[  ][  ][  ][  ][  ][Wl][  ][Hu]
[  ][Wr][  ][  ][  ][Hd][  ][  ]
[  ][  ][  ][  ][  ][  ][  ][Ex]
