[D ][Hr][Hu][  ][  ][Wl][  ][  ]
[  ][  ][  ][  ][  ][  ][  ][  ]
[B ][Wl][  ][  ][  ][  ][  ][B ]
[  ][  ][  ][  ][  ][  ][  ][  ]
[  ][  ][  ][  ][  ][B ][  ][  ]
[  ][  ][  ][  ][  ][  ][  ][  ]
[  ][  ][Hd][  ][  ][  ][Hd][  ]
[  ][  ][  ][  ][  ][  ][  ][Ex]
