[D ][  ][Wd][  ][  ][  ][  ][  ]
[  ][  ][  ][  ][  ][  ][  ][  ]
[  ][  ][  ][  ][  ][  ][B ][  ]
[  ][  ][  ][  ][  ][Wr][  ][  ]
[  ][  ][B ][  ][Hu][  ][B ][  ]
[  ][  ][Wu][  ][  ][Wl][  ][  ]
[  ][  ][  ][  ][  ][Wr][  ][  ]
[  ][  ][  ][  ][  ][  ][  ][Ex]
