[D ][  ][  ][Hr][  ][  ][  ][  ]
[  ][  ][  ][Hu][  ][  ][  ][  ]
[B ][Wl][Wl][  ][  ][  ][  ][  ]
[  ][  ][  ][  ][  ][  ][Wl][  ]
[  ][  ][B ][Wu][  ][B ][  ][  ]
[  ][  ][  ][  ][  ][  ][  ][  ]
[  ][  ][  ][  ][  ][  ][  ][B ]
[  ][  ][  ][  ][  ][  ][  ][Ex]
