[D ][  ][  ][  ][  ][  ][  ][  ]
[  ][  ][B ][  ][  ][  ][  ][  ]
[B ][Wl][  ][  ][  ][  ][  ][B ]
[  ][  ][  ][  ][  ][  ][Hr][  ]
[B ][Hd][  ][B ][  ][Wd][  ][  ]
[Wl][  ][  ][  ][  ][Wr][B ][  ]
[  ][  ][B ][Wr][  ][  ][Hu][  ]
[  ][  ][  ][  ][  ][  ][  ][Ex]
