[D ][  ][Wr][  ][B ][  ][  ][  ]
[  ][  ][  ][  ][  ][  ][  ][  ]
[  ][  ][  ][  ][  ][  ][  ][B ]
[B ][  ][  ][  ][  ][  ][Hr][  ]
[B ][  ][  ][  ][  ][Wd][Wr][  ]
[B ][  ][Hr][  ][Wd][  ][  ][Wl]
[  ][  ][Wr][  ][  ][  ][  ][  ]
[  ][  ][  ][  ][  ][  ][  ][Ex]
