[  ][Wl][  ][Hr][Hu][Hr][B ][  ][  ][  ][  ][  ][Wl][  ][  ][  ]
[B ][B ][Wu][Wl][  ][  ][  ][  ][  ][  ][  ][  ][  ][  ][  ][Wl]
[  ][  ][  ][  ][  ][Hr][  ][  ][B ][  ][Hr][Hd][  ][  ][  ][  ]
[  ][Wr][  ][B ][B ][Wd][  ][Wl][  ][  ][  ][Hl][  ][  ][  ][  ]
[B ][  ][  ][  ][Hr][  ][  ][Wu][  ][  ][Hr][  ][  ][B ][  ][  ]
[  ][  ][  ][Wr][  ][  ][Hl][  ][  ][B ][  ][  ][  ][  ][  ][  ]
[Hu][B ][Hr][Ex][  ][  ][  ][B ][  ][  ][Hr][  ][  ][B ][  ][  ]
[B ][  ][  ][  ][  ][Hr][  ][  ][B ][Wd][  ][  ][  ][  ][Hu][  ]
[  ][  ][  ][  ][Wl][D ][  ][Hl][Hl][  ][  ][  ][  ][B ][Wd][  ]
