[  ][B ][  ][  ][Hu][Hu][  ][  ][  ][Wr][  ][  ][Wl][  ][B ][  ]
[  ][  ][Wu][  ][  ][  ][B ][  ][  ][B ][  ][  ][  ][  ][  ][  ]
[  ][  ][Hd][B ][  ][  ][  ][  ][  ][  ][  ][  ][  ][  ][Wl][Hl]
[  ][  ][  ][  ][  ][  ][  ][Hu][  ][  ][  ][  ][  ][  ][  ][  ]
[  ][  ][  ][Wu][Hr][  ][  ][  ][  ][  ][  ][  ][  ][Wd][  ][  ]
[  ][  ][Wr][  ][Hu][Wu][  ][  ][  ][B ][  ][  ][  ][  ][  ][  ]
[  ][  ][  ][Ex][  ][  ][  ][  ][  ][  ][Hl][  ][  ][  ][  ][Hd]
[  ][B ][  ][  ][  ][  ][  ][  ][  ][  ][  ][  ][  ][  ][  ][  ]
[  ][Hd][  ][  ][  ][D ][Wr][  ][  ][Hu][  ][  ][  ][B ][  ][  ]
