[  ][  ][  ][  ][Hu][  ][  ][  ][  ][B ][  ][  ][Wl][  ][  ][  ]
[  ][  ][Wu][  ][  ][  ][  ][  ][  ][  ][  ][  ][Hu][  ][  ][  ]
[  ][  ][  ][  ][  ][Hd][  ][  ][  ][  ][Wl][Hd][  ][  ][  ][Hl]
[  ][Wr][  ][  ][B ][  ][  ][  ][  ][  ][  ][  ][  ][  ][  ][  ]
[  ][  ][  ][  ][Hr][  ][  ][  ][  ][  ][  ][  ][  ][  ][  ][  ]
[  ][  ][  ][Wr][B ][  ][  ][  ][  ][Hr][  ][  ][  ][  ][  ][  ]
[Hl][  ][Hr][Ex][  ][  ][  ][Wl][  ][  ][  ][  ][  ][  ][  ][  ]
[B ][  ][  ][  ][  ][  ][  ][  ][  ][Wd][  ][  ][  ][  ][Hu][  ]
[  ][  ][  ][  ][B ][D ][  ][  ][  ][  ][  ][  ][  ][B ][Wd][  ]
