[  ][  ][  ][  ][Hu][  ][  ][  ][  ][  ][  ][  ][Wl][  ][  ][Wu]
[  ][  ][Wu][  ][  ][  ][  ][  ][  ][  ][  ][  ][  ][  ][  ][  ]
[  ][  ][  ][  ][  ][  ][  ][  ][  ][  ][  ][  ][  ][  ][  ][Hl]
[  ][Wr][  ][  ][  ][  ][  ][Wl][  ][  ][  ][  ][  ][  ][  ][  ]
[  ][  ][  ][  ][Hr][  ][  ][  ][  ][  ][  ][  ][  ][  ][  ][  ]
[  ][  ][  ][Wr][Hu][  ][  ][  ][  ][Hr][  ][  ][  ][  ][  ][  ]
[Hl][  ][  ][Ex][  ][  ][  ][  ][  ][  ][  ][  ][  ][  ][  ][Hd]
[  ][  ][  ][  ][  ][  ][  ][  ][  ][  ][  ][  ][  ][  ][  ][  ]
[  ][  ][  ][  ][  ][D ][  ][  ][  ][  ][  ][  ][  ][  ][  ][  ]
