[  ][Hd][Wl][  ][Hu][Hr][  ][  ][  ][  ][  ][B ][Wu][  ][Hu][  ]
[  ][Hl][Hr][  ][Wd][  ][B ][Wr][  ][  ][B ][Wd][B ][Wl][  ][Hr]
[Wr][  ][Hr][  ][  ][Hd][  ][  ][  ][  ][Wl][Hr][  ][  ][  ][  ]
[  ][Wr][Hu][  ][B ][Wl][  ][  ][  ][Hl][  ][  ][Hd][Wd][  ][B ]
[  ][Wr][  ][  ][Hr][B ][  ][  ][  ][  ][  ][  ][  ][  ][  ][Wr]
[  ][B ][  ][  ][B ][  ][  ][Wd][  ][  ][  ][Wd][  ][B ][  ][  ]
[B ][  ][  ][Ex][  ][  ][  ][  ][Wd][Wd][B ][  ][  ][  ][  ][  ]
[  ][  ][  ][Hl][  ][  ][  ][  ][  ][Wr][  ][B ][  ][  ][Hu][  ]
[Wr][  ][  ][  ][B ][D ][  ][Hu][  ][B ][Wr][  ][  ][  ][Wd][B ]
