[  ][Wd][Hr][Wl][Hu][Hr][  ][  ][  ][  ][  ][B ][Wu][  ][Hu][  ]
[  ][  ][Hr][  ][Wd][  ][B ][  ][  ][  ][B ][Wd][B ][Wl][  ][Hr]
[Wr][  ][Hr][  ][  ][Hd][  ][  ][  ][  ][  ][Hr][  ][  ][  ][  ]
[  ][Wr][Hu][  ][B ][Wl][  ][Hr][  ][Hl][Hr][  ][  ][Wd][Wd][B ]
[  ][  ][  ][  ][Hr][B ][  ][  ][Hd][  ][  ][  ][  ][  ][  ][Wr]
[  ][  ][  ][Hr][B ][  ][  ][Wd][  ][  ][  ][Wd][  ][B ][  ][  ]
[B ][  ][  ][Ex][  ][  ][  ][Wl][Wd][Wd][B ][  ][  ][  ][  ][  ]
[  ][  ][  ][Hl][  ][  ][  ][  ][  ][Wr][  ][B ][  ][  ][  ][  ]
[Wr][  ][  ][  ][B ][D ][  ][  ][  ][B ][Wr][  ][  ][  ][Wd][B ]
