[Wl][  ][  ][  ][Hu][Hr][  ][  ][  ][B ][  ][  ][Wl][Wl][  ][Wu]
[  ][  ][Wu][  ][  ][  ][  ][  ][B ][  ][  ][  ][  ][  ][  ][  ]
[  ][  ][  ][  ][  ][Hd][Wr][  ][B ][  ][Wl][  ][  ][  ][  ][Hl]
[  ][Wu][  ][  ][B ][  ][  ][  ][  ][  ][  ][  ][  ][  ][  ][  ]
[  ][  ][  ][  ][Hr][  ][  ][  ][  ][  ][  ][  ][  ][  ][  ][B ]
[Hl][  ][  ][Wr][B ][  ][  ][  ][  ][Hr][  ][  ][  ][  ][  ][  ]
[Hl][  ][Hr][Ex][  ][B ][  ][  ][  ][  ][  ][  ][  ][  ][B ][  ]
[B ][  ][  ][Hu][  ][  ][  ][  ][  ][  ][  ][  ][  ][  ][Hu][  ]
[  ][  ][  ][  ][B ][D ][  ][  ][Wd][  ][  ][  ][B ][B ][Wd][Wu]
