[  ][Hd][  ][Wl][Hu][Hr][  ][  ][  ][  ][  ][B ][Wu][  ][Hu][  ]
[  ][  ][Hr][  ][B ][  ][  ][  ][  ][  ][  ][Wd][Hu][Wl][  ][Hr]
[Wr][B ][Hr][  ][  ][Hd][  ][  ][  ][  ][Wl][Hr][  ][  ][  ][  ]
[  ][Wr][  ][  ][B ][Wl][  ][Hr][  ][Hl][  ][  ][Hd][Wd][Wd][B ]
[  ][  ][  ][  ][Hr][B ][  ][  ][  ][  ][  ][  ][  ][  ][  ][  ]
[  ][  ][  ][  ][B ][  ][  ][Wd][  ][  ][  ][  ][  ][B ][  ][  ]
[B ][  ][  ][Ex][  ][  ][  ][Wl][Wd][  ][Wu][  ][B ][  ][  ][  ]
[  ][  ][  ][Hl][  ][  ][  ][  ][  ][Wr][  ][B ][  ][  ][Hu][  ]
[Wr][  ][  ][  ][B ][D ][  ][Hu][  ][B ][Wr][  ][  ][  ][Wd][B ]
