[  ][  ][  ][  ][Hu][  ][  ][  ][  ][B ][  ][B ][  ][  ][  ][  ]
[  ][  ][Wu][  ][  ][  ][  ][  ][  ][  ][  ][  ][Hu][  ][Wl][  ]
[  ][  ][  ][  ][  ][Hd][  ][  ][  ][  ][Wl][Hd][  ][  ][Wr][Wr]
[  ][Wr][  ][  ][  ][  ][  ][  ][  ][  ][B ][  ][  ][  ][  ][  ]
[  ][  ][Wu][Hd][  ][  ][  ][  ][  ][  ][Wu][  ][  ][  ][  ][Hd]
[  ][  ][  ][Wr][B ][B ][  ][  ][  ][Hr][  ][  ][  ][  ][  ][B ]
[Hl][  ][  ][Ex][  ][B ][  ][Wl][  ][  ][B ][  ][Hl][  ][  ][  ]
[B ][  ][  ][  ][  ][  ][  ][  ][  ][Wd][  ][  ][  ][  ][Hu][  ]
[  ][  ][  ][  ][B ][D ][  ][  ][  ][  ][  ][  ][  ][Wd][Wd][  ]
