[  ][Hd][Hr][Wl][  ][Hr][  ][  ][  ][  ][  ][B ][Wu][  ][Hu][  ]
[  ][  ][Hr][  ][Wd][  ][B ][  ][  ][  ][B ][Wd][B ][Wl][  ][Hr]
[Wr][  ][Hr][  ][  ][Hd][  ][  ][  ][  ][Wl][Hr][  ][  ][  ][  ]
[  ][Wr][Hu][  ][B ][Wl][  ][Hr][  ][Hl][Hr][  ][Hd][Wd][Wd][B ]
[  ][  ][  ][  ][Hr][B ][  ][  ][  ][  ][  ][  ][  ][  ][  ][Wr]
[  ][  ][  ][Hr][B ][  ][  ][Wd][  ][  ][  ][Wd][  ][B ][  ][  ]
[B ][  ][  ][Ex][  ][  ][  ][Wl][Wd][Wd][B ][  ][  ][  ][  ][  ]
[  ][  ][  ][Hl][  ][  ][  ][  ][  ][Wr][  ][B ][  ][  ][  ][  ]
[Wr][  ][  ][  ][B ][D ][  ][  ][  ][B ][Wr][  ][  ][  ][Wd][B ]
