[Wl][  ][  ][  ][Hu][Hr][  ][  ][  ][  ][  ][  ][Wl][Wl][  ][Wu]
[  ][  ][Wu][  ][  ][  ][  ][  ][B ][  ][  ][  ][  ][  ][  ][  ]
[  ][B ][  ][  ][  ][Hd][  ][  ][B ][  ][  ][  ][  ][  ][  ][Hl]
[  ][Wu][  ][  ][B ][  ][  ][  ][  ][  ][  ][  ][  ][  ][  ][Hu]
[  ][  ][  ][  ][Hr][  ][  ][  ][  ][  ][  ][  ][  ][  ][  ][B ]
[Hl][  ][  ][Wr][B ][  ][  ][  ][  ][Hr][  ][Wr][  ][  ][  ][  ]
[Hl][  ][Hr][Ex][  ][B ][Hr][  ][  ][  ][  ][  ][  ][  ][B ][  ]
[  ][  ][  ][Hu][  ][  ][  ][  ][  ][  ][  ][  ][  ][  ][Hu][  ]
[  ][  ][  ][  ][B ][D ][  ][  ][  ][Hl][  ][  ][B ][B ][  ][Wu]
