[  ][Hd][Hr][  ][Hu][Hr][  ][  ][  ][  ][  ][B ][Wu][  ][Hu][  ]
[  ][  ][Hr][  ][Wd][  ][B ][  ][  ][  ][B ][Wd][B ][Wl][  ][Hr]
[Wr][  ][Hr][Hd][  ][  ][  ][  ][  ][  ][Wl][Hr][  ][  ][  ][  ]
[  ][Wr][Hu][  ][B ][Wl][  ][Hr][  ][Hl][Hr][  ][Hd][Wd][  ][B ]
[  ][Wr][  ][  ][Hr][B ][  ][  ][  ][  ][Hr][  ][  ][  ][  ][Wr]
[  ][B ][  ][Hr][B ][  ][  ][Wd][  ][  ][  ][Wd][  ][B ][  ][  ]
[B ][  ][  ][Ex][  ][  ][  ][Wl][Wd][Wd][B ][  ][  ][  ][  ][  ]
[  ][  ][  ][Hl][  ][  ][  ][  ][  ][Wr][  ][B ][  ][  ][Hu][  ]
[Wr][  ][  ][  ][B ][D ][  ][Hu][  ][B ][Wr][  ][  ][  ][Wd][B ]
