[  ][  ][  ][  ][Hu][Hr][  ][  ][  ][B ][  ][  ][Wl][  ][  ][Wu]
[  ][  ][Wu][  ][  ][  ][  ][  ][  ][  ][  ][  ][  ][  ][  ][  ]
[  ][  ][  ][  ][  ][Hd][  ][  ][  ][  ][Wl][  ][  ][  ][  ][Hl]
[  ][  ][  ][  ][B ][  ][  ][Wl][  ][  ][  ][  ][  ][  ][  ][  ]
[  ][  ][  ][  ][Hr][  ][  ][  ][  ][  ][  ][  ][  ][  ][  ][  ]
[  ][  ][  ][Wr][B ][  ][  ][  ][  ][Hr][  ][  ][  ][  ][  ][  ]
[Hl][  ][Hr][Ex][  ][  ][  ][  ][  ][  ][  ][  ][  ][  ][  ][B ]
[B ][  ][  ][  ][  ][  ][  ][  ][  ][Wd][  ][  ][  ][  ][Hu][  ]
[  ][  ][  ][  ][B ][D ][  ][  ][  ][  ][  ][  ][  ][B ][Wd][  ]
