[D ][  ][  ][  ][  ][  ][  ][  ]
[  ][  ][  ][Wu][  ][  ][  ][  ]
[  ][  ][  ][  ][  ][  ][  ][  ]
[B ][  ][  ][  ][  ][  ][  ][  ]
[  ][  ][  ][  ][  ][Wr][  ][  ]
[  ][B ][  ][  ][  ][Wr][  ][  ]
[  ][  ][  ][  ][  ][  ][  ][  ]
[  ][  ][  ][  ][Hd][  ][  ][Ex]
