[D ][  ][  ][  ][  ][  ][  ][  ]
[  ][  ][  ][  ][  ][  ][  ][B ]
[  ][  ][  ][  ][  ][  ][  ][  ]
[  ][  ][  ][  ][Hl][Hd][  ][  ]
[  ][  ][  ][  ][  ][  ][Wr][  ]
[  ][  ][  ][  ][Hr][  ][  ][  ]
[  ][  ][  ][  ][  ][  ][  ][  ]
[  ][  ][  ][  ][  ][  ][  ][Ex]
