[D ][  ][  ][  ][B ][  ][  ][  ]
[  ][  ][  ][  ][B ][  ][  ][  ]
[  ][  ][  ][B ][  ][  ][  ][  ]
[  ][  ][  ][  ][  ][  ][  ][  ]
[  ][  ][  ][  ][  ][  ][  ][  ]
[  ][B ][  ][  ][  ][  ][B ][  ]
[  ][  ][  ][  ][  ][  ][Wd][  ]
[B ][  ][  ][  ][  ][  ][  ][Ex]
