[D ][  ][  ][  ][  ][  ][Hu][  ]
[  ][B ][  ][  ][  ][  ][  ][  ]
[Wr][Wd][  ][  ][  ][  ][  ][  ]
[  ][Hr][  ][  ][  ][  ][  ][  ]
[  ][  ][  ][  ][  ][  ][  ][  ]
[  ][  ][  ][  ][  ][  ][  ][  ]
[Wr][  ][  ][  ][  ][  ][  ][  ]
[  ][  ][  ][  ][  ][  ][  ][Ex]
