[D ][  ][  ][  ][  ][  ][  ][  ]
[  ][  ][  ][  ][  ][  ][  ][  ]
[  ][  ][  ][Hu][  ][  ][  ][  ]
[  ][  ][  ][  ][Wu][  ][  ][Wl]
[  ][  ][  ][  ][Wl][Wd][  ][  ]
[  ][  ][  ][  ][  ][  ][  ][  ]
[  ][  ][  ][  ][  ][  ][  ][  ]
[  ][  ][  ][  ][  ][  ][  ][Ex]
