[D ][  ][  ][Wl][  ][  ][  ][  ]
[  ][  ][  ][  ][  ][  ][  ][  ]
[Hd][  ][  ][  ][  ][  ][  ][  ]
[  ][  ][  ][  ][  ][  ][  ][  ]
[Wd][  ][  ][  ][  ][  ][  ][  ]
[  ][  ][  ][  ][  ][  ][  ][  ]
[  ][  ][  ][Hl][  ][  ][  ][Wu]
[  ][  ][  ][  ][  ][  ][  ][Ex]
