[D ][  ][  ][  ][  ][  ][  ][  ]
[  ][  ][  ][  ][  ][  ][Wu][  ]
[  ][  ][  ][Wd][  ][  ][  ][  ]
[  ][  ][Wl][  ][  ][  ][  ][  ]
[  ][  ][  ][  ][  ][  ][  ][B ]
[Wl][  ][  ][  ][  ][Wr][  ][  ]
[  ][  ][Hl][  ][  ][  ][  ][  ]
[  ][  ][  ][  ][  ][  ][  ][Ex]
