[D ][  ][Wd][  ][  ][  ][  ][  ]
[  ][  ][  ][  ][  ][  ][  ][  ]
[  ][  ][  ][  ][  ][  ][  ][  ]
[  ][  ][  ][  ][  ][B ][  ][  ]
[  ][  ][  ][  ][  ][  ][  ][  ]
[  ][  ][B ][  ][  ][  ][B ][  ]
[  ][  ][  ][Hr][  ][  ][  ][  ]
[  ][  ][  ][  ][  ][Wu][  ][Ex]
