[D ][  ][  ][  ][  ][  ][  ][  ]
[  ][  ][  ][  ][  ][  ][  ][  ]
[  ][  ][  ][Wr][  ][  ][  ][  ]
[  ][  ][  ][  ][  ][  ][  ][  ]
[  ][  ][  ][  ][  ][  ][  ][  ]
[Wl][  ][  ][  ][  ][  ][  ][  ]
[  ][  ][  ][  ][  ][  ][  ][  ]
[  ][Wu][  ][Wu][  ][  ][  ][Ex]
