[  ][  ][Wd][Hd][  ][  ][  ][  ][  ][  ][  ][B ][  ][  ][  ][Hu]
[  ][  ][  ][  ][  ][  ][  ][B ][  ][  ][  ][  ][B ][  ][  ][Wr]
[B ][  ][  ][  ][  ][  ][Wr][Hl][  ][  ][  ][  ][  ][  ][  ][  ]
[  ][  ][  ][  ][  ][  ][  ][  ][  ][  ][  ][Hr][Ex][Hu][  ][  ]
[  ][  ][  ][  ][  ][  ][  ][  ][  ][  ][  ][  ][  ][Hd][  ][  ]
[  ][  ][  ][  ][  ][  ][  ][  ][  ][  ][  ][  ][  ][  ][  ][Wd]
[  ][  ][  ][  ][  ][  ][B ][  ][  ][B ][  ][Wu][D ][  ][  ][  ]
[  ][Hu][  ][Hd][  ][  ][  ][Hd][  ][  ][  ][B ][B ][B ][B ][  ]
[  ][  ][Hl][  ][Wd][  ][  ][  ][  ][  ][  ][  ][Wr][Wu][  ][  ]
