[  ][  ][  ][Hr][Hl][Hu][  ][  ][Wu][  ][Hr][B ][  ][Hd][  ][B ]
[  ][  ][Hr][Wd][  ][Wr][  ][B ][  ][  ][  ][B ][  ][Wu][  ][Hu]
[Wl][  ][  ][  ][  ][  ][  ][  ][  ][  ][  ][B ][  ][  ][  ][B ]
[  ][Wd][Wd][  ][  ][  ][Wu][Wl][D ][  ][  ][  ][  ][  ][  ][Hu]
[  ][  ][  ][B ][  ][B ][  ][Wl][  ][  ][  ][  ][  ][  ][  ][B ]
[  ][  ][  ][  ][  ][  ][Hl][Ex][  ][  ][  ][  ][  ][  ][  ][Wu]
[  ][  ][B ][  ][  ][Hl][  ][  ][  ][  ][  ][B ][B ][B ][B ][  ]
[  ][  ][  ][  ][  ][  ][Hd][  ][  ][  ][  ][Wl][  ][Wd][  ][  ]
[Wr][  ][  ][B ][  ][Hd][B ][  ][B ][  ][Wl][Wd][Hd][B ][  ][  ]
