[  ][  ][  ][B ][  ][  ][  ][  ][Hr][  ][Wd][  ][Hl][B ][  ][  ]
[  ][Hr][B ][  ][Hd][  ][  ][  ][  ][  ][Hl][B ][  ][  ][  ][  ]
[Wl][  ][B ][  ][B ][  ][  ][  ][  ][  ][Hr][Wr][Hr][  ][  ][B ]
[B ][  ][B ][  ][Hr][Hl][  ][  ][D ][  ][Wd][  ][  ][Hu][Wd][  ]
[B ][  ][  ][  ][  ][  ][  ][  ][  ][Wd][  ][  ][  ][  ][  ][B ]
[  ][  ][Wd][Hd][  ][  ][  ][Ex][Wr][  ][  ][Hr][  ][  ][Hl][  ]
[  ][  ][  ][  ][  ][Hl][  ][  ][  ][B ][Hl][B ][B ][  ][  ][  ]
[  ][  ][  ][  ][  ][  ][Hd][Hd][  ][  ][  ][Hr][  ][Wd][Hd][  ]
[  ][Wr][B ][B ][  ][B ][B ][  ][B ][Wd][B ][Hu][  ][B ][Hr][  ]
