[  ][  ][  ][  ][  ][  ][  ][  ][  ][  ][  ][  ][  ][Wd][  ][  ]
[  ][  ][  ][  ][  ][B ][  ][B ][  ][  ][  ][  ][  ][B ][  ][Wr]
[Hu][B ][Wd][  ][  ][  ][  ][Hr][Hu][  ][  ][  ][  ][  ][  ][  ]
[  ][Wr][  ][  ][  ][Wr][  ][  ][  ][B ][  ][  ][Ex][Hu][  ][  ]
[Wd][B ][  ][  ][  ][  ][Wd][Wr][B ][  ][  ][  ][  ][B ][  ][  ]
[  ][  ][Wr][Wr][Wl][  ][  ][  ][  ][  ][  ][  ][  ][  ][  ][Wd]
[  ][  ][  ][  ][  ][  ][B ][  ][  ][B ][  ][  ][D ][  ][  ][  ]
[  ][  ][  ][Wu][B ][  ][  ][  ][B ][  ][Hl][  ][  ][B ][B ][B ]
[  ][  ][Hl][Hl][Wd][Wl][Hu][  ][  ][  ][  ][Wu][B ][  ][  ][  ]
