[  ][Wr][  ][Hr][Hl][Hu][Hd][  ][Wu][  ][Hr][B ][Wr][Hd][  ][B ]
[  ][B ][B ][Wd][  ][  ][B ][B ][B ][  ][  ][B ][  ][B ][  ][Hu]
[B ][  ][  ][  ][B ][  ][Hd][  ][Wl][  ][  ][B ][  ][  ][  ][B ]
[  ][  ][Wd][  ][  ][Wr][B ][  ][D ][  ][Wl][  ][  ][  ][  ][Hu]
[  ][Hu][  ][B ][  ][B ][  ][Wl][  ][  ][  ][  ][  ][  ][  ][B ]
[  ][  ][  ][B ][  ][  ][  ][Ex][  ][  ][  ][Wl][  ][  ][  ][Wu]
[  ][  ][Hr][Wd][  ][  ][  ][Wr][Hd][B ][  ][  ][B ][B ][  ][  ]
[  ][  ][  ][  ][B ][Hl][  ][  ][  ][  ][  ][Wl][  ][B ][  ][Wl]
[Wr][  ][  ][B ][B ][Wu][  ][B ][  ][Hu][Wl][Wd][Wr][Hr][Hr][  ]
