[Wr][  ][  ][Wu][  ][Wu][  ][Wu][Hr][  ][  ][  ][  ][B ][  ][Wd]
[  ][  ][Hr][Wd][  ][  ][Wd][B ][  ][Hd][  ][B ][  ][  ][  ][  ]
[Wl][  ][B ][  ][  ][Hu][B ][  ][  ][  ][  ][  ][Hu][  ][  ][  ]
[Hd][B ][  ][  ][Wr][Hd][  ][  ][D ][  ][Wd][  ][  ][Hu][Wd][  ]
[  ][  ][  ][  ][  ][B ][  ][  ][  ][  ][  ][  ][  ][  ][  ][B ]
[  ][  ][Wr][  ][  ][  ][  ][Ex][  ][  ][  ][  ][  ][Wd][  ][Wu]
[  ][  ][B ][  ][  ][Hl][  ][  ][  ][Wr][B ][B ][B ][  ][  ][  ]
[  ][  ][  ][  ][  ][  ][  ][  ][  ][  ][  ][Wr][  ][Wd][  ][Hl]
[  ][  ][  ][B ][  ][Wd][B ][  ][B ][  ][  ][Hu][  ][B ][Hr][  ]
