[  ][  ][  ][B ][  ][  ][  ][  ][Hr][  ][  ][  ][  ][B ][  ][  ]
[  ][  ][Hr][Wd][  ][  ][Wd][  ][  ][  ][  ][B ][  ][  ][  ][  ]
[Wl][  ][B ][  ][  ][  ][  ][  ][  ][  ][  ][  ][Hu][  ][  ][  ]
[Hd][  ][  ][  ][  ][Hd][  ][  ][D ][  ][Wd][  ][  ][Hu][Wd][  ]
[  ][  ][  ][  ][  ][B ][  ][  ][  ][  ][  ][  ][  ][  ][  ][B ]
[  ][  ][  ][  ][  ][  ][  ][Ex][  ][  ][  ][  ][  ][  ][  ][Wu]
[  ][  ][B ][  ][  ][Hl][  ][  ][  ][Wr][B ][B ][B ][  ][  ][  ]
[  ][  ][  ][  ][  ][  ][  ][  ][  ][  ][  ][Wl][  ][Wd][Hd][Hl]
[  ][  ][  ][B ][  ][  ][B ][  ][B ][  ][  ][Hu][  ][B ][Hr][  ]
