[  ][  ][B ][B ][Hl][Hu][  ][  ][Wu][  ][Hr][B ][  ][Hd][  ][  ]
[  ][  ][Hr][Wd][  ][Wr][  ][B ][  ][  ][  ][B ][  ][Wu][  ][Hu]
[Wl][  ][  ][  ][  ][  ][  ][  ][  ][  ][  ][B ][  ][  ][  ][B ]
[  ][Wd][Wd][  ][  ][  ][Wu][Wl][D ][  ][Wd][  ][  ][  ][  ][Hd]
[  ][  ][  ][  ][  ][B ][  ][  ][  ][  ][  ][  ][  ][  ][  ][  ]
[  ][Hd][  ][  ][  ][  ][Hl][Ex][  ][  ][Wd][  ][  ][  ][  ][Wu]
[  ][  ][B ][Wu][Wr][Hu][  ][  ][  ][  ][  ][B ][B ][B ][B ][  ]
[  ][  ][  ][  ][  ][  ][Hd][  ][  ][  ][  ][Wl][  ][Wd][  ][  ]
[Wr][  ][  ][B ][  ][Hd][  ][  ][B ][  ][Wl][  ][Hd][B ][  ][  ]
