[Wr][  ][  ][B ][  ][  ][  ][  ][  ][  ][  ][  ][  ][B ][  ][  ]
[  ][  ][Wu][Wd][  ][  ][B ][  ][  ][  ][  ][B ][  ][  ][  ][  ]
[B ][B ][B ][  ][  ][  ][  ][  ][  ][Wr][  ][Wd][Hu][B ][  ][Hd]
[  ][  ][Wd][Hl][  ][Hd][  ][  ][D ][  ][Wr][B ][  ][Hu][Wd][  ]
[  ][  ][  ][  ][  ][B ][  ][  ][  ][  ][  ][  ][  ][  ][  ][B ]
[  ][  ][  ][  ][Hl][  ][  ][Ex][Hr][  ][  ][Hd][  ][  ][  ][  ]
[  ][  ][  ][  ][  ][  ][  ][Hd][  ][Wr][  ][B ][  ][  ][  ][  ]
[  ][  ][  ][  ][  ][B ][Hd][  ][  ][  ][  ][Wl][  ][Wd][Hd][  ]
[Wl][  ][  ][B ][  ][B ][B ][  ][B ][Wu][  ][Hu][  ][B ][Hr][  ]
