[  ][  ][  ][  ][  ][  ][  ][  ][  ][  ][  ][Wr][  ][  ][  ][  ]
[  ][  ][  ][  ][  ][B ][  ][B ][  ][  ][  ][  ][  ][B ][  ][Wr]
[Hu][  ][  ][  ][  ][  ][  ][Hu][Hu][  ][  ][  ][  ][  ][  ][  ]
[  ][  ][  ][  ][  ][Wr][  ][  ][  ][  ][  ][  ][Ex][Hu][  ][  ]
[  ][  ][  ][  ][  ][  ][Wd][Wr][B ][  ][  ][  ][  ][B ][  ][  ]
[  ][  ][Wr][  ][  ][  ][  ][  ][  ][  ][  ][  ][  ][  ][  ][Wd]
[  ][  ][  ][  ][  ][  ][B ][  ][  ][B ][  ][  ][D ][  ][  ][  ]
[  ][  ][  ][Hd][B ][  ][  ][  ][B ][  ][Hl][  ][  ][B ][B ][B ]
[  ][  ][Hl][  ][Wd][Wl][B ][  ][  ][  ][  ][Wu][  ][  ][  ][  ]
