[  ][  ][  ][  ][  ][  ][Wd][  ][  ][  ][  ][  ][  ][  ][Wd][  ]
[  ][  ][  ][  ][Hd][  ][B ][  ][Hu][  ][  ][D ][  ][  ][  ][  ]
[  ][Hl][  ][  ][  ][B ][B ][  ][  ][  ][  ][  ][  ][  ][  ][  ]
[Wd][  ][  ][  ][  ][  ][  ][  ][  ][  ][Hd][  ][  ][  ][Hd][  ]
[  ][  ][  ][B ][Wu][  ][  ][  ][  ][  ][  ][  ][Ex][Wu][  ][  ]
[Wl][  ][  ][  ][  ][  ][  ][  ][B ][  ][Wr][  ][  ][  ][  ][Hu]
[  ][  ][  ][  ][  ][B ][Wd][Hl][  ][  ][  ][  ][  ][  ][  ][B ]
[  ][  ][  ][  ][  ][  ][B ][  ][  ][  ][  ][Wl][  ][  ][  ][  ]
[  ][  ][  ][Hl][  ][Hd][  ][  ][  ][  ][  ][  ][  ][  ][  ][  ]
