[  ][Wr][  ][Hr][  ][Hu][  ][  ][B ][  ][Hr][B ][  ][  ][  ][B ]
[Wr][B ][B ][Wd][Hu][  ][B ][B ][B ][  ][Wd][B ][  ][B ][  ][  ]
[B ][  ][  ][Wd][B ][  ][Hd][  ][Wl][  ][  ][B ][  ][  ][  ][B ]
[  ][  ][Wd][  ][  ][Wr][  ][  ][D ][  ][  ][Wr][  ][  ][  ][Hu]
[  ][Hu][  ][  ][  ][B ][  ][Wl][  ][  ][  ][  ][  ][  ][  ][B ]
[  ][  ][  ][B ][  ][  ][  ][Ex][  ][  ][  ][Wl][Wr][Wd][  ][Wu]
[  ][  ][Hr][Wd][  ][  ][  ][Wr][Hd][B ][  ][  ][B ][B ][  ][  ]
[  ][  ][  ][  ][B ][Hl][  ][  ][  ][  ][  ][Wl][  ][B ][  ][  ]
[Wr][  ][  ][B ][B ][  ][  ][  ][  ][Hu][Wl][Wd][Wr][  ][  ][  ]
