[  ][  ][  ][B ][  ][Hu][  ][  ][Hr][  ][  ][  ][  ][B ][  ][Wl]
[  ][  ][Hr][Wd][  ][  ][Wd][  ][  ][  ][  ][B ][  ][  ][  ][  ]
[Wl][  ][B ][  ][  ][  ][Wd][  ][  ][  ][  ][  ][Hu][  ][  ][  ]
[  ][Hu][Wd][  ][  ][Hd][  ][  ][D ][  ][Wd][  ][  ][Hu][Wd][  ]
[  ][  ][  ][  ][  ][B ][  ][  ][  ][  ][  ][  ][  ][  ][  ][B ]
[  ][  ][  ][  ][  ][  ][  ][Ex][  ][  ][  ][  ][  ][  ][  ][Wu]
[  ][  ][B ][  ][  ][  ][  ][  ][  ][Wr][Hl][B ][B ][  ][  ][  ]
[  ][  ][  ][  ][  ][  ][Hd][Wd][  ][  ][  ][Wl][  ][Wd][Hd][  ]
[  ][  ][Hd][B ][  ][  ][B ][  ][B ][  ][  ][Hu][  ][B ][Hr][  ]
