[  ][  ][  ][  ][  ][  ][  ][  ][  ][  ][  ][  ][  ][Wd][  ][  ]
[B ][Wu][  ][  ][  ][B ][  ][B ][  ][  ][  ][  ][  ][B ][Hl][Wr]
[Hu][B ][Wd][  ][  ][  ][Wu][Hr][Hu][Wr][  ][  ][  ][  ][  ][Wu]
[  ][Wr][  ][  ][  ][Wr][  ][  ][Wu][B ][  ][  ][Ex][Hu][  ][  ]
[Wd][B ][  ][  ][  ][  ][Wd][Wr][  ][  ][  ][  ][  ][B ][Wu][  ]
[Hd][  ][Wr][Wr][Wl][  ][  ][  ][  ][  ][  ][  ][  ][B ][  ][Hr]
[  ][Hd][  ][  ][  ][  ][B ][  ][  ][B ][  ][  ][D ][  ][  ][  ]
[  ][  ][  ][Wu][B ][  ][  ][  ][B ][  ][Hl][  ][  ][B ][B ][B ]
[  ][  ][Hl][Hl][B ][Wl][Hu][  ][  ][  ][  ][Wu][B ][  ][Hd][  ]
