[  ][  ][  ][  ][  ][  ][Wd][  ][  ][  ][  ][  ][  ][  ][Wd][  ]
[  ][  ][  ][  ][Hr][  ][  ][  ][Hu][  ][  ][D ][  ][  ][  ][  ]
[  ][Hl][  ][  ][  ][  ][B ][  ][  ][  ][  ][  ][  ][  ][  ][  ]
[  ][  ][  ][  ][  ][  ][  ][  ][  ][  ][  ][  ][  ][  ][  ][  ]
[  ][  ][  ][B ][Wu][  ][  ][  ][  ][  ][  ][  ][Ex][  ][  ][  ]
[Wl][  ][  ][  ][  ][  ][  ][  ][  ][  ][Wr][  ][  ][  ][  ][Hu]
[  ][  ][  ][  ][  ][B ][  ][  ][  ][  ][  ][  ][  ][  ][  ][  ]
[  ][  ][  ][  ][  ][  ][B ][  ][  ][  ][  ][B ][  ][  ][  ][  ]
[  ][  ][  ][  ][  ][  ][  ][  ][  ][  ][  ][  ][  ][  ][  ][  ]
