[  ][  ][  ][  ][Hd][  ][Wd][  ][  ][  ][  ][  ][  ][  ][Wd][  ]
[  ][  ][  ][  ][Wr][B ][B ][  ][Hu][  ][  ][D ][B ][  ][  ][  ]
[  ][Wr][  ][  ][Hu][B ][B ][  ][  ][  ][  ][  ][  ][  ][  ][  ]
[Wd][Wr][  ][  ][  ][B ][  ][  ][  ][  ][  ][  ][  ][  ][Wl][  ]
[  ][  ][  ][B ][Wu][  ][  ][  ][  ][B ][  ][  ][Ex][Wu][  ][  ]
[Wl][  ][  ][  ][  ][  ][  ][  ][B ][  ][Wr][  ][  ][  ][  ][Hu]
[Wd][  ][  ][  ][  ][B ][Hl][Hd][  ][  ][  ][  ][  ][  ][  ][B ]
[  ][  ][  ][  ][  ][  ][B ][  ][Wl][  ][  ][Wl][  ][  ][  ][  ]
[  ][  ][  ][Hl][  ][Hd][  ][  ][  ][  ][  ][  ][  ][  ][  ][  ]
