[  ][  ][  ][  ][  ][  ][  ][  ][Hr][  ][  ][  ][  ][B ][  ][  ]
[  ][  ][Hr][Wd][  ][  ][Wd][  ][  ][  ][  ][B ][  ][  ][  ][  ]
[Wl][  ][B ][  ][  ][  ][Wd][  ][  ][Hd][  ][  ][Hu][  ][  ][  ]
[Hd][Wu][  ][  ][  ][Hd][  ][  ][D ][  ][  ][  ][  ][Hu][Wd][  ]
[  ][  ][  ][  ][  ][B ][  ][  ][  ][  ][  ][  ][  ][  ][  ][B ]
[  ][Wr][  ][  ][  ][  ][  ][Ex][  ][  ][  ][  ][  ][  ][  ][  ]
[  ][Wr][B ][  ][  ][Hl][  ][  ][  ][Wr][B ][B ][B ][  ][  ][  ]
[  ][  ][  ][  ][  ][  ][  ][  ][  ][  ][  ][  ][  ][Wd][Hd][  ]
[  ][  ][  ][B ][  ][  ][  ][  ][B ][  ][  ][B ][  ][B ][  ][  ]
