[  ][  ][  ][  ][  ][  ][  ][  ][  ][  ][Hu][  ][  ][  ][  ][  ]
[  ][  ][  ][  ][  ][  ][  ][B ][  ][B ][  ][  ][  ][B ][  ][  ]
[  ][  ][  ][  ][  ][  ][B ][  ][  ][  ][  ][  ][  ][  ][Hd][Wd]
[  ][  ][  ][  ][  ][Wd][  ][  ][  ][  ][  ][  ][Ex][  ][  ][  ]
[  ][  ][  ][Hd][  ][  ][  ][  ][B ][  ][  ][  ][  ][B ][Hd][  ]
[  ][  ][  ][B ][  ][  ][  ][  ][  ][  ][  ][B ][  ][  ][  ][Wd]
[  ][  ][  ][  ][  ][  ][B ][  ][  ][B ][  ][  ][D ][  ][  ][  ]
[  ][Wu][Hd][Hd][  ][  ][  ][  ][  ][  ][  ][  ][  ][B ][B ][  ]
[  ][B ][Hl][  ][Wd][  ][  ][  ][  ][  ][B ][  ][  ][  ][  ][  ]
