[  ][  ][  ][  ][  ][  ][  ][  ][  ][  ][  ][  ][  ][Wd][  ][  ]
[  ][Wu][  ][  ][  ][B ][  ][B ][  ][  ][  ][  ][  ][B ][Hl][Wr]
[Hu][B ][Wd][  ][  ][  ][Wu][Hr][Hu][B ][  ][  ][  ][  ][B ][Wu]
[  ][Wr][  ][  ][  ][Wr][  ][  ][Wu][B ][  ][  ][Ex][Hu][  ][  ]
[Wd][B ][  ][  ][  ][  ][Wd][Wr][  ][  ][  ][  ][  ][  ][Wu][  ]
[Hd][  ][Wr][Hr][Wl][  ][  ][  ][  ][  ][  ][  ][  ][B ][  ][Hr]
[  ][Hd][  ][  ][  ][  ][B ][  ][  ][B ][  ][  ][D ][  ][  ][  ]
[  ][  ][  ][Wu][  ][  ][  ][  ][B ][  ][Hl][  ][  ][B ][Hl][  ]
[  ][  ][Hl][Hl][B ][Wl][Hu][  ][  ][  ][  ][Wu][B ][  ][Hd][  ]
