[  ][  ][  ][B ][  ][Hu][  ][  ][Hr][  ][  ][  ][  ][  ][  ][  ]
[  ][  ][Hr][Wd][  ][  ][Wd][  ][  ][  ][  ][B ][  ][  ][  ][  ]
[Wl][  ][B ][  ][  ][  ][  ][  ][  ][  ][  ][  ][Hu][  ][  ][  ]
[Hd][Hu][Wd][  ][  ][Hd][  ][  ][D ][  ][Wd][  ][  ][Hu][Wd][  ]
[  ][  ][  ][  ][  ][B ][  ][  ][  ][  ][  ][  ][  ][  ][  ][  ]
[  ][Wd][  ][  ][  ][  ][  ][Ex][  ][  ][  ][  ][  ][  ][  ][Wu]
[  ][  ][B ][  ][  ][Hl][  ][  ][  ][Wr][Hl][B ][B ][  ][  ][  ]
[  ][  ][  ][  ][  ][  ][Hd][  ][  ][  ][Wl][Wl][  ][Wd][Hd][  ]
[  ][  ][Hd][B ][  ][  ][B ][  ][B ][  ][  ][Hu][  ][B ][Hr][  ]
