[  ][  ][  ][B ][Hl][Hu][  ][  ][Wu][  ][Hr][Wu][  ][B ][  ][  ]
[  ][  ][Hr][Wd][  ][Wr][  ][Wr][  ][  ][  ][B ][  ][Wu][  ][  ]
[Wl][  ][B ][  ][  ][  ][  ][  ][  ][  ][  ][  ][Hu][  ][  ][B ]
[  ][Hu][Wd][  ][  ][  ][  ][Wl][D ][  ][Wd][  ][  ][  ][Wd][  ]
[  ][  ][  ][B ][  ][B ][  ][  ][  ][  ][  ][  ][  ][  ][  ][B ]
[  ][  ][  ][  ][  ][  ][  ][Ex][  ][  ][  ][  ][  ][  ][  ][Wu]
[  ][  ][B ][Wu][  ][Hl][  ][  ][Wu][  ][B ][B ][B ][B ][B ][  ]
[  ][  ][  ][  ][  ][  ][Hd][  ][  ][  ][  ][Wl][  ][Wd][  ][  ]
[Wr][  ][  ][B ][  ][  ][B ][  ][B ][  ][Wd][Wd][  ][B ][Hr][  ]
