[  ][B ][B ][Hr][Hl][Hu][  ][  ][Wu][  ][Hr][B ][  ][Hd][  ][B ]
[  ][  ][Hr][Wd][  ][  ][  ][B ][  ][  ][  ][B ][  ][Wu][  ][Hu]
[B ][  ][  ][  ][  ][  ][  ][  ][  ][  ][  ][B ][  ][  ][  ][  ]
[  ][Wd][Wd][  ][  ][  ][Wu][  ][D ][  ][  ][  ][  ][  ][  ][Hu]
[  ][Hu][  ][B ][  ][B ][  ][Wl][  ][  ][  ][  ][  ][  ][  ][B ]
[  ][  ][  ][B ][  ][  ][Hl][Ex][  ][  ][  ][Wu][  ][  ][  ][Wu]
[  ][  ][  ][  ][  ][Hl][  ][B ][  ][  ][  ][B ][B ][B ][B ][  ]
[  ][  ][  ][  ][  ][Hl][Hd][Hu][  ][  ][  ][Wl][  ][B ][  ][  ]
[Wr][Hr][  ][B ][  ][Wu][B ][B ][B ][  ][Wl][Wd][Wr][Hr][Hr][  ]
