[  ][  ][  ][  ][  ][  ][  ][  ][  ][  ][  ][  ][  ][  ][  ][Hu]
[  ][  ][  ][  ][  ][  ][  ][B ][  ][  ][  ][  ][B ][  ][  ][Wr]
[Hu][  ][  ][  ][  ][  ][Wr][  ][  ][  ][  ][  ][  ][  ][  ][  ]
[  ][  ][  ][  ][  ][  ][  ][  ][  ][  ][  ][  ][Ex][Hu][  ][  ]
[  ][  ][  ][  ][  ][  ][  ][  ][  ][  ][  ][  ][  ][  ][  ][  ]
[  ][  ][  ][  ][  ][  ][  ][  ][  ][  ][  ][  ][  ][  ][  ][Wd]
[  ][  ][  ][  ][  ][  ][B ][  ][  ][B ][  ][  ][D ][  ][  ][  ]
[  ][  ][  ][Hd][  ][  ][  ][  ][  ][  ][B ][  ][  ][B ][B ][  ]
[  ][  ][Hl][  ][Wd][  ][  ][  ][  ][  ][  ][  ][  ][  ][  ][  ]
