[  ][Wr][  ][Hr][Hl][Hu][  ][  ][Wu][  ][Hr][B ][Wr][  ][  ][B ]
[Wr][B ][B ][Wd][  ][  ][B ][B ][B ][  ][Wd][B ][  ][B ][  ][  ]
[B ][  ][  ][Wd][B ][  ][Hd][  ][Wl][  ][  ][B ][  ][  ][  ][B ]
[  ][  ][Wd][  ][  ][Wr][  ][  ][D ][  ][  ][Wr][  ][  ][  ][Hu]
[  ][Hu][  ][B ][  ][B ][  ][Wl][  ][  ][  ][  ][  ][  ][  ][B ]
[  ][  ][  ][B ][  ][  ][  ][Ex][  ][  ][  ][Wl][Wr][Wd][  ][Wu]
[  ][  ][Hr][Wd][  ][  ][  ][Wr][Hd][B ][  ][  ][B ][B ][  ][  ]
[  ][  ][  ][  ][B ][Hl][  ][  ][  ][  ][  ][Wl][  ][B ][  ][Wl]
[Wr][  ][  ][B ][B ][  ][  ][  ][  ][Hu][Wl][Wd][Wr][  ][  ][  ]
