[  ][  ][  ][  ][  ][  ][  ][  ][  ][  ][B ][  ][  ][  ][  ][  ]
[  ][  ][  ][  ][  ][B ][  ][  ][  ][  ][Wu][Wd][  ][Hl][  ][Wr]
[Hu][  ][  ][  ][  ][  ][Wr][Hu][Hu][  ][  ][B ][  ][  ][  ][  ]
[  ][  ][  ][  ][  ][Wr][  ][  ][  ][  ][B ][Wl][Ex][Hu][  ][  ]
[  ][  ][B ][  ][  ][  ][  ][Wr][B ][  ][  ][  ][  ][B ][  ][  ]
[Hd][  ][Wr][B ][  ][  ][  ][  ][  ][  ][  ][  ][  ][  ][  ][Wd]
[  ][  ][  ][  ][  ][  ][B ][  ][  ][B ][B ][  ][D ][Hd][  ][  ]
[  ][  ][  ][Hd][B ][  ][  ][  ][B ][  ][Hl][  ][  ][  ][B ][B ]
[  ][  ][Hl][  ][Wd][B ][B ][  ][  ][  ][Wu][  ][  ][  ][  ][  ]
