[  ][  ][  ][B ][  ][Hu][  ][  ][Hr][  ][  ][  ][  ][B ][  ][  ]
[  ][  ][Hr][Wd][  ][  ][Wd][  ][  ][  ][  ][B ][  ][  ][  ][  ]
[Wl][  ][B ][  ][  ][  ][  ][  ][  ][  ][  ][  ][Hu][  ][  ][  ]
[  ][Hu][Wd][  ][  ][Hd][  ][  ][D ][  ][Wd][  ][  ][  ][Wd][  ]
[  ][  ][  ][  ][  ][B ][  ][  ][  ][  ][  ][  ][  ][  ][  ][B ]
[  ][  ][  ][  ][  ][  ][  ][Ex][  ][  ][  ][  ][  ][  ][  ][Wu]
[  ][  ][B ][  ][  ][Hl][  ][  ][  ][Wr][Hl][B ][B ][  ][  ][  ]
[  ][  ][  ][  ][  ][  ][Hd][  ][  ][  ][  ][Wl][  ][Wd][Hd][  ]
[  ][  ][  ][B ][  ][  ][B ][  ][B ][  ][  ][Hu][  ][B ][Hr][  ]
