[B ][  ][B ][B ][Hl][Hu][  ][B ][Wu][B ][  ][B ][  ][Hd][  ][Hr]
[  ][  ][  ][Wd][B ][Wr][  ][B ][  ][  ][  ][B ][  ][Wl][  ][Hu]
[Wl][  ][  ][  ][  ][  ][  ][  ][  ][  ][  ][B ][  ][  ][  ][B ]
[  ][Wd][Wd][Wd][  ][  ][Wu][Wl][D ][  ][Wd][  ][  ][  ][  ][Hu]
[  ][  ][  ][B ][  ][B ][  ][  ][  ][  ][  ][  ][Wr][  ][  ][  ]
[  ][  ][Wd][  ][Hu][  ][Hl][Ex][  ][  ][Hu][  ][Wl][  ][  ][Wu]
[  ][  ][B ][Hd][Wr][Hu][  ][  ][  ][  ][  ][B ][B ][  ][B ][  ]
[  ][  ][  ][  ][B ][  ][  ][  ][  ][  ][  ][Wl][  ][Wd][  ][  ]
[Wr][  ][  ][B ][  ][Hd][  ][  ][  ][  ][Wl][Wd][  ][Wr][  ][  ]
