[D ][  ][  ][  ][B ][  ][  ][  ]
[  ][  ][  ][  ][  ][Hu][  ][  ]
[  ][  ][  ][B ][  ][  ][  ][  ]
[  ][  ][  ][Hu][  ][  ][  ][  ]
[  ][  ][  ][  ][  ][  ][  ][  ]
[  ][Wu][  ][  ][  ][  ][  ][  ]
[  ][  ][  ][  ][  ][  ][Wu][  ]
[  ][  ][  ][  ][  ][  ][  ][Ex]
