[D ][  ][  ][  ][  ][  ][  ][  ]
[  ][  ][  ][  ][Hr][  ][  ][  ]
[B ][  ][  ][  ][  ][Hd][Wu][  ]
[  ][  ][  ][  ][  ][  ][  ][Wr]
[  ][  ][  ][  ][  ][Wl][  ][  ]
[  ][  ][  ][  ][  ][  ][  ][  ]
[  ][  ][  ][  ][  ][  ][  ][  ]
[  ][  ][  ][  ][  ][  ][  ][Ex]
