[D ][  ][  ][  ][  ][  ][  ][  ]
[  ][  ][  ][  ][  ][  ][  ][  ]
[  ][  ][  ][  ][  ][  ][  ][  ]
[  ][Hd][Hl][  ][  ][  ][  ][  ]
[  ][  ][  ][  ][  ][  ][  ][B ]
[  ][  ][  ][Wl][  ][  ][  ][  ]
[  ][Wu][B ][B ][  ][  ][  ][  ]
[  ][  ][  ][  ][  ][Wu][  ][Ex]
