[D ][  ][  ][  ][  ][  ][  ][  ]
[  ][  ][  ][  ][Wr][Hl][  ][  ]
[Wu][  ][  ][  ][  ][  ][  ][  ]
[  ][  ][  ][  ][  ][  ][  ][  ]
[  ][  ][Hu][  ][  ][  ][  ][  ]
[  ][  ][  ][  ][  ][  ][  ][  ]
[Hr][  ][  ][  ][  ][  ][  ][  ]
[  ][  ][  ][  ][  ][  ][  ][Ex]
