[D ][  ][  ][  ][  ][  ][  ][  ]
[  ][  ][  ][  ][  ][  ][  ][  ]
[  ][  ][  ][  ][  ][  ][  ][  ]
[  ][  ][  ][  ][  ][  ][  ][  ]
[  ][  ][  ][  ][  ][  ][B ][B ]
[  ][B ][  ][Wl][  ][B ][  ][  ]
[  ][Wu][  ][B ][  ][  ][  ][  ]
[B ][  ][  ][  ][  ][  ][  ][Ex]
