[D ][  ][  ][Hl][  ][  ][  ][  ]
[  ][  ][Wd][  ][  ][  ][  ][Wr]
[  ][  ][  ][  ][  ][  ][  ][  ]
[  ][  ][  ][  ][  ][  ][  ][  ]
[  ][  ][B ][  ][  ][  ][  ][  ]
[  ][  ][  ][  ][  ][  ][  ][  ]
[  ][  ][  ][  ][B ][  ][  ][  ]
[  ][  ][  ][  ][Wd][  ][  ][Ex]
