[D ][  ][  ][  ][  ][  ][Wr][  ]
[  ][Wu][  ][  ][  ][B ][B ][  ]
[  ][  ][  ][  ][  ][  ][  ][  ]
[  ][  ][  ][  ][  ][  ][Hu][  ]
[  ][  ][  ][  ][  ][  ][  ][  ]
[  ][  ][  ][  ][  ][  ][  ][  ]
[  ][  ][  ][Wl][  ][  ][  ][  ]
[  ][  ][  ][  ][  ][  ][  ][Ex]
