[D ][  ][B ][  ][  ][  ][  ][  ]
[  ][  ][  ][  ][Wu][  ][Hd][  ]
[  ][  ][  ][  ][  ][  ][  ][  ]
[  ][  ][  ][  ][  ][  ][  ][  ]
[  ][Hr][  ][  ][  ][  ][  ][  ]
[  ][  ][  ][  ][  ][  ][B ][  ]
[  ][  ][B ][  ][  ][  ][  ][  ]
[  ][Hu][  ][  ][  ][  ][  ][Ex]
