[D ][  ][  ][  ][  ][  ][  ][Wr]
[  ][  ][  ][  ][  ][  ][  ][Wu]
[  ][  ][B ][Wd][  ][  ][  ][  ]
[  ][  ][  ][  ][  ][  ][  ][  ]
[  ][  ][  ][Hu][  ][B ][  ][  ]
[  ][  ][  ][  ][  ][  ][  ][  ]
[  ][Wu][  ][Hu][Wl][  ][  ][  ]
[  ][  ][  ][  ][  ][  ][  ][Ex]
