[D ][  ][  ][  ][  ][  ][  ][Hd]
[  ][  ][  ][  ][Hr][  ][  ][  ]
[  ][  ][  ][  ][  ][  ][  ][Wl]
[  ][  ][  ][  ][  ][  ][  ][Wu]
[B ][  ][Hd][  ][  ][  ][  ][Wu]
[Wr][Hr][  ][B ][  ][  ][  ][B ]
[  ][  ][  ][  ][  ][Wr][  ][  ]
[  ][  ][  ][Wr][  ][  ][  ][Ex]
