[D ][Wd][B ][  ][  ][  ][  ][  ]
[  ][  ][Wd][  ][  ][  ][  ][  ]
[  ][  ][  ][  ][  ][  ][  ][  ]
[  ][  ][  ][  ][  ][  ][  ][  ]
[  ][  ][  ][B ][  ][  ][  ][Wr]
[  ][  ][  ][  ][  ][B ][  ][Hd]
[Wd][  ][  ][  ][  ][  ][  ][  ]
[Hl][  ][  ][B ][B ][B ][  ][Ex]
