[D ][  ][Wr][  ][  ][  ][  ][  ]
[  ][  ][  ][  ][  ][  ][  ][  ]
[B ][  ][  ][  ][  ][  ][  ][  ]
[Hl][  ][  ][  ][  ][  ][Hr][  ]
[B ][  ][B ][  ][  ][Wd][  ][  ]
[B ][  ][Hr][  ][  ][Wr][  ][  ]
[  ][  ][Wr][Wr][  ][Hu][  ][  ]
[  ][Wu][  ][  ][  ][  ][  ][Ex]
