[D ][  ][  ][  ][  ][  ][  ][  ]
[  ][  ][  ][  ][  ][  ][  ][  ]
[  ][  ][  ][  ][  ][  ][Wu][Wd]
[  ][  ][  ][B ][  ][  ][Hl][  ]
[  ][  ][  ][  ][  ][  ][B ][  ]
[Wr][  ][Wu][  ][  ][  ][  ][  ]
[  ][  ][Wl][  ][  ][Wr][  ][  ]
[  ][  ][  ][  ][  ][  ][  ][Ex]
