[D ][  ][  ][B ][  ][  ][  ][  ]
[  ][  ][B ][  ][  ][  ][  ][B ]
[  ][Wr][  ][  ][  ][  ][  ][Wd]
[B ][  ][  ][  ][  ][  ][  ][Hu]
[  ][  ][B ][  ][  ][Hu][  ][  ]
[  ][  ][  ][  ][  ][  ][Wl][  ]
[  ][  ][Wl][  ][  ][  ][Wd][Wd]
[  ][  ][Wu][  ][  ][  ][  ][Ex]
