[D ][  ][  ][B ][  ][B ][Hr][  ]
[  ][  ][B ][  ][  ][  ][  ][  ]
[B ][  ][  ][  ][  ][Hd][Hu][B ]
[  ][  ][  ][B ][  ][Wu][  ][Hr]
[  ][  ][  ][Wu][  ][  ][  ][  ]
[  ][Hr][Wr][  ][  ][B ][  ][  ]
[  ][  ][  ][  ][  ][  ][  ][  ]
[  ][B ][B ][Wd][  ][  ][  ][Ex]
