[D ][  ][  ][  ][  ][  ][  ][  ]
[  ][  ][  ][  ][  ][  ][Wd][  ]
[B ][Wl][  ][  ][  ][  ][  ][Wl]
[  ][  ][  ][  ][  ][  ][Hr][  ]
[B ][  ][  ][B ][  ][Wd][  ][  ]
[  ][  ][Hr][  ][  ][Wr][  ][Wl]
[  ][  ][Wr][  ][  ][  ][  ][  ]
[  ][  ][  ][  ][  ][  ][  ][Ex]
