[D ][Hl][  ][  ][  ][Wu][  ][  ]
[  ][  ][  ][  ][  ][Wr][  ][  ]
[  ][  ][  ][B ][  ][  ][  ][  ]
[  ][  ][Wu][  ][  ][  ][Hu][  ]
[  ][  ][B ][Wu][  ][  ][  ][  ]
[  ][  ][  ][  ][  ][  ][  ][  ]
[  ][  ][  ][  ][  ][  ][Wd][Hr]
[  ][  ][  ][  ][  ][Wr][  ][Ex]
