[D ][  ][  ][  ][  ][B ][  ][  ]
[  ][  ][Wd][  ][  ][  ][  ][  ]
[  ][  ][  ][  ][  ][  ][Wd][  ]
[  ][  ][  ][  ][  ][  ][Wu][Wu]
[  ][  ][  ][  ][B ][  ][  ][  ]
[  ][  ][  ][  ][  ][  ][  ][  ]
[Wl][  ][  ][  ][  ][  ][  ][  ]
[  ][  ][B ][  ][  ][B ][  ][Ex]
