[D ][  ][  ][B ][B ][Wu][  ][  ]
[  ][  ][  ][  ][  ][  ][B ][  ]
[  ][  ][  ][  ][  ][  ][  ][Wd]
[B ][  ][  ][  ][  ][  ][  ][  ]
[  ][  ][B ][  ][  ][  ][B ][  ]
[  ][  ][  ][  ][  ][  ][  ][  ]
[  ][  ][Wl][  ][  ][Wr][Wd][  ]
[  ][  ][  ][  ][B ][  ][  ][Ex]
