[D ][  ][  ][  ][  ][  ][  ][Wr]
[Wd][  ][  ][  ][  ][  ][  ][Wu]
[  ][  ][  ][  ][Wd][  ][  ][Wd]
[Hd][  ][  ][  ][Wl][  ][  ][  ]
[  ][  ][  ][  ][  ][  ][  ][  ]
[  ][  ][  ][  ][  ][  ][  ][  ]
[  ][  ][Hu][  ][  ][  ][  ][  ]
[Hl][  ][Hl][  ][  ][Hu][  ][Ex]
