[D ][  ][  ][B ][  ][  ][  ][Hd]
[  ][  ][  ][  ][Hr][  ][  ][  ]
[  ][  ][Wu][  ][  ][  ][  ][Wl]
[  ][  ][Hd][  ][  ][  ][  ][Wu]
[B ][  ][Hd][  ][  ][  ][  ][  ]
[Wr][Hr][B ][  ][  ][  ][  ][B ]
[Hl][Wr][  ][  ][  ][Wr][  ][  ]
[  ][  ][  ][  ][  ][B ][  ][Ex]
