[D ][  ][  ][  ][  ][  ][  ][Wr]
[  ][  ][  ][  ][  ][  ][  ][Wu]
[  ][  ][B ][Wd][Wd][  ][  ][  ]
[  ][  ][  ][  ][Wl][  ][  ][  ]
[  ][  ][Wd][  ][  ][B ][  ][  ]
[  ][  ][  ][  ][  ][  ][  ][  ]
[Hl][Wu][  ][  ][  ][  ][  ][  ]
[  ][  ][  ][  ][  ][  ][  ][Ex]
