[D ][  ][  ][Hr][  ][  ][  ][  ]
[  ][  ][  ][Wd][  ][  ][  ][  ]
[B ][Wl][  ][  ][  ][  ][  ][  ]
[  ][  ][  ][  ][  ][  ][Wd][  ]
[  ][  ][  ][Wu][  ][  ][  ][  ]
[  ][  ][  ][  ][  ][  ][  ][Wu]
[  ][  ][  ][  ][  ][  ][  ][  ]
[  ][  ][  ][  ][  ][  ][  ][Ex]
