[D ][  ][  ][  ][  ][  ][  ][  ]
[  ][  ][  ][  ][  ][  ][  ][  ]
[B ][Wl][  ][  ][  ][  ][  ][B ]
[  ][  ][  ][  ][  ][  ][Hr][  ]
[  ][  ][  ][  ][  ][Wd][Wr][  ]
[B ][  ][Hr][  ][  ][  ][  ][  ]
[  ][  ][Hd][B ][  ][  ][  ][  ]
[  ][  ][  ][  ][  ][  ][  ][Ex]
