[D ][  ][Hu][B ][  ][  ][Hr][  ]
[  ][  ][Wd][  ][  ][  ][  ][  ]
[B ][  ][  ][  ][  ][Hd][  ][B ]
[  ][  ][  ][B ][  ][  ][  ][Wu]
[  ][  ][  ][  ][  ][  ][  ][Wl]
[  ][  ][Wr][  ][  ][B ][  ][  ]
[Wl][Hl][  ][  ][  ][  ][  ][  ]
[  ][  ][  ][  ][  ][  ][  ][Ex]
