[D ][  ][  ][  ][  ][  ][Wd][  ]
[  ][  ][B ][  ][  ][  ][  ][Wu]
[  ][  ][  ][  ][  ][  ][  ][Wd]
[  ][  ][  ][  ][  ][  ][  ][  ]
[  ][  ][  ][Hl][  ][Wd][  ][  ]
[  ][  ][  ][  ][  ][  ][  ][  ]
[  ][Wu][  ][Hu][  ][Wr][  ][  ]
[  ][  ][  ][  ][  ][  ][  ][Ex]
