[D ][  ][  ][  ][  ][  ][  ][Wr]
[Wd][  ][  ][  ][  ][  ][  ][Wu]
[  ][  ][  ][  ][Wd][  ][  ][Wd]
[  ][  ][  ][B ][Wl][  ][Hl][  ]
[  ][  ][  ][  ][  ][B ][  ][  ]
[  ][  ][  ][  ][B ][  ][  ][  ]
[  ][  ][  ][  ][  ][  ][  ][  ]
[Hl][  ][  ][  ][  ][Hd][  ][Ex]
