[D ][  ][  ][  ][  ][Wu][  ][  ]
[  ][  ][  ][  ][  ][  ][Wl][  ]
[  ][  ][  ][  ][  ][  ][  ][Wd]
[B ][  ][  ][  ][  ][  ][  ][  ]
[  ][  ][Hl][  ][  ][  ][B ][  ]
[  ][  ][  ][  ][  ][  ][  ][  ]
[  ][  ][Wl][  ][  ][Wr][Wd][  ]
[  ][  ][  ][  ][  ][  ][  ][Ex]
