[D ][  ][  ][  ][  ][  ][  ][Wr]
[Wd][  ][  ][  ][  ][  ][  ][Wu]
[  ][  ][B ][  ][Wd][  ][  ][Wd]
[  ][  ][  ][  ][Wl][  ][Hl][  ]
[  ][  ][  ][  ][  ][B ][  ][  ]
[  ][  ][  ][  ][Wd][  ][  ][  ]
[  ][  ][Hu][  ][  ][  ][  ][  ]
[Hl][  ][  ][  ][  ][  ][  ][Ex]
