[D ][  ][  ][  ][Hd][  ][  ][  ]
[  ][  ][  ][  ][  ][  ][  ][Wr]
[  ][  ][  ][  ][B ][  ][  ][Wd]
[B ][  ][  ][  ][  ][  ][Wu][  ]
[  ][Wl][B ][  ][  ][  ][  ][  ]
[  ][  ][  ][  ][  ][  ][  ][  ]
[  ][  ][Hu][Hu][  ][Wr][  ][  ]
[  ][  ][Wd][  ][  ][  ][Wl][Ex]
