[D ][  ][Wr][Wu][  ][  ][Wd][  ]
[  ][  ][B ][  ][  ][  ][  ][  ]
[  ][  ][  ][  ][  ][Wu][  ][Wd]
[  ][  ][  ][  ][  ][  ][  ][  ]
[  ][  ][  ][Hl][  ][  ][  ][B ]
[  ][B ][  ][B ][  ][  ][  ][  ]
[  ][Wu][  ][Hu][  ][  ][  ][  ]
[  ][  ][  ][  ][  ][  ][  ][Ex]
