[D ][  ][  ][  ][  ][  ][  ][  ]
[  ][  ][  ][  ][  ][  ][  ][  ]
[  ][  ][  ][  ][  ][  ][  ][Wd]
[B ][  ][  ][  ][  ][  ][  ][Hu]
[  ][  ][B ][  ][  ][  ][  ][  ]
[  ][  ][  ][  ][  ][  ][B ][  ]
[  ][  ][Wl][  ][  ][  ][Wd][Wd]
[  ][  ][Wu][  ][  ][  ][  ][Ex]
