[D ][  ][  ][  ][  ][  ][  ][  ]
[  ][Wu][B ][  ][Hl][  ][  ][Wu]
[  ][  ][  ][  ][  ][  ][  ][  ]
[  ][  ][  ][  ][  ][  ][  ][  ]
[  ][  ][  ][  ][  ][B ][  ][  ]
[  ][  ][  ][  ][  ][  ][  ][  ]
[  ][  ][  ][  ][  ][Wr][Hl][  ]
[  ][  ][  ][  ][  ][  ][  ][Ex]
