[D ][  ][  ][  ][  ][  ][  ][  ]
[  ][  ][  ][  ][  ][  ][  ][Wr]
[  ][Wl][  ][  ][  ][  ][Wd][B ]
[  ][  ][  ][Hd][  ][  ][Hd][  ]
[  ][  ][  ][B ][  ][  ][  ][  ]
[  ][  ][  ][  ][  ][  ][B ][Wr]
[  ][  ][  ][B ][  ][  ][  ][  ]
[  ][  ][B ][  ][  ][  ][  ][Ex]
