[D ][  ][  ][  ][B ][  ][  ][  ]
[  ][Wu][B ][  ][Hl][  ][  ][Wu]
[  ][Wl][  ][Wr][  ][  ][  ][  ]
[  ][  ][  ][  ][  ][  ][  ][  ]
[  ][  ][  ][  ][  ][B ][  ][  ]
[  ][  ][  ][  ][  ][  ][  ][  ]
[  ][B ][  ][  ][  ][  ][Hl][  ]
[  ][  ][  ][  ][B ][  ][  ][Ex]
