[D ][  ][  ][  ][  ][  ][  ][Wr]
[Wd][  ][  ][  ][  ][  ][  ][Wu]
[  ][  ][  ][  ][Wd][  ][  ][  ]
[  ][  ][Wu][B ][Wl][  ][  ][  ]
[  ][  ][  ][  ][  ][B ][  ][  ]
[  ][  ][  ][  ][B ][  ][  ][  ]
[B ][  ][  ][  ][  ][  ][  ][  ]
[Hl][  ][  ][  ][  ][Hd][  ][Ex]
