[D ][  ][B ][  ][  ][Wl][Hr][  ]
[  ][  ][Wd][  ][  ][Hd][  ][  ]
[B ][  ][  ][  ][  ][  ][  ][B ]
[  ][  ][  ][B ][  ][  ][  ][  ]
[  ][  ][  ][  ][  ][  ][  ][  ]
[  ][  ][Wr][  ][  ][B ][  ][  ]
[Wl][  ][  ][  ][  ][  ][  ][  ]
[  ][  ][  ][  ][  ][  ][  ][Ex]
