[D ][  ][  ][B ][Hr][  ][  ][  ]
[  ][  ][  ][  ][  ][  ][  ][  ]
[  ][  ][  ][  ][  ][  ][Wu][Wd]
[Hr][  ][  ][  ][Hl][  ][  ][B ]
[  ][  ][  ][  ][  ][  ][B ][  ]
[  ][  ][  ][B ][  ][  ][  ][  ]
[Wd][Wl][  ][  ][  ][Wr][  ][  ]
[  ][  ][  ][  ][  ][  ][  ][Ex]
