[D ][  ][Wd][  ][B ][Wu][  ][  ]
[  ][  ][  ][  ][  ][  ][B ][  ]
[  ][  ][  ][  ][Hu][  ][  ][Wd]
[B ][  ][  ][  ][  ][  ][  ][  ]
[  ][  ][  ][B ][B ][  ][B ][  ]
[  ][  ][  ][  ][  ][  ][  ][  ]
[  ][  ][Wl][Hu][  ][Wr][Wd][  ]
[  ][  ][  ][  ][  ][  ][  ][Ex]
