[D ][  ][Wr][  ][  ][  ][  ][  ]
[  ][  ][B ][  ][  ][  ][  ][  ]
[  ][  ][  ][  ][  ][  ][  ][B ]
[B ][  ][B ][  ][  ][  ][  ][  ]
[B ][  ][  ][B ][  ][Wd][Wr][  ]
[  ][  ][Hl][  ][  ][  ][  ][  ]
[Wd][  ][Wr][Hl][  ][  ][  ][  ]
[  ][  ][Wd][  ][  ][  ][  ][Ex]
