[D ][  ][  ][  ][  ][  ][  ][  ]
[  ][  ][  ][  ][  ][B ][  ][  ]
[  ][  ][  ][  ][  ][  ][  ][B ]
[  ][B ][  ][  ][  ][  ][Hr][B ]
[Wl][  ][B ][Wl][  ][Wd][  ][  ]
[B ][  ][B ][  ][  ][Wr][  ][  ]
[  ][  ][Wr][Wr][  ][Hu][  ][  ]
[  ][Wu][  ][  ][  ][  ][  ][Ex]
