[D ][  ][  ][  ][  ][  ][  ][  ]
[  ][  ][  ][  ][Hu][  ][  ][  ]
[B ][Wl][  ][  ][  ][  ][  ][B ]
[  ][  ][  ][  ][  ][  ][Hr][  ]
[B ][Hd][  ][  ][  ][Wd][  ][  ]
[Wl][  ][  ][  ][  ][Wr][  ][  ]
[  ][  ][Hr][Wr][  ][  ][  ][  ]
[  ][  ][  ][  ][  ][  ][  ][Ex]
