[D ][  ][  ][B ][  ][  ][  ][  ]
[Hd][  ][  ][  ][  ][  ][  ][  ]
[  ][  ][  ][  ][  ][  ][B ][  ]
[  ][  ][  ][  ][  ][Wr][  ][  ]
[  ][  ][B ][  ][Hu][  ][B ][  ]
[  ][  ][  ][  ][  ][B ][  ][  ]
[  ][  ][  ][  ][  ][Wr][  ][  ]
[  ][  ][Wu][  ][  ][  ][  ][Ex]
