[D ][  ][Hu][  ][  ][  ][Hr][  ]
[  ][  ][Wd][  ][  ][  ][  ][  ]
[B ][  ][  ][  ][  ][Wr][  ][B ]
[  ][  ][  ][B ][  ][  ][  ][Hr]
[  ][  ][  ][  ][  ][  ][  ][Wl]
[  ][Hr][Wr][  ][  ][B ][  ][  ]
[Wl][Wl][  ][  ][  ][  ][Wl][Wu]
[  ][  ][B ][  ][  ][  ][  ][Ex]
