[D ][  ][  ][Wu][  ][  ][Wd][  ]
[  ][  ][  ][  ][  ][  ][  ][Wu]
[  ][  ][  ][  ][  ][Wu][  ][Wd]
[  ][  ][  ][  ][  ][  ][  ][  ]
[  ][B ][  ][Hd][  ][Wd][  ][  ]
[  ][  ][  ][B ][  ][  ][  ][  ]
[  ][Hd][  ][Hu][  ][  ][  ][  ]
[  ][  ][  ][  ][  ][  ][  ][Ex]
