[D ][  ][B ][  ][  ][  ][  ][  ]
[  ][  ][Wd][  ][  ][  ][  ][  ]
[  ][  ][  ][  ][  ][  ][  ][  ]
[  ][  ][  ][  ][  ][  ][  ][Wu]
[  ][  ][  ][B ][  ][  ][  ][  ]
[  ][  ][  ][  ][  ][B ][  ][Hd]
[Wl][  ][  ][  ][  ][  ][  ][  ]
[  ][  ][  ][  ][  ][B ][  ][Ex]
