[D ][  ][  ][Wd][  ][  ][  ][B ]
[  ][  ][B ][  ][  ][  ][  ][  ]
[B ][Wl][  ][Hu][  ][  ][  ][Wl]
[  ][  ][  ][  ][  ][  ][Hr][  ]
[B ][  ][  ][  ][  ][Wd][  ][  ]
[Wl][Hr][Hr][  ][  ][  ][  ][  ]
[  ][  ][Wr][  ][  ][  ][  ][  ]
[  ][  ][  ][  ][  ][  ][  ][Ex]
