[D ][  ][  ][  ][  ][Wu][  ][  ]
[  ][  ][  ][  ][  ][  ][  ][  ]
[  ][  ][Wd][  ][  ][  ][  ][  ]
[Hu][  ][  ][  ][  ][  ][  ][Wd]
[  ][  ][  ][  ][  ][B ][B ][  ]
[  ][  ][  ][  ][  ][  ][  ][Hu]
[  ][  ][  ][  ][  ][Wl][  ][  ]
[  ][  ][  ][  ][  ][  ][  ][Ex]
