[D ][  ][  ][  ][  ][Wu][  ][Hd]
[  ][  ][  ][  ][  ][  ][  ][  ]
[  ][B ][  ][  ][  ][  ][  ][  ]
[  ][  ][  ][Wd][Wu][  ][  ][  ]
[Wl][  ][  ][  ][  ][B ][  ][  ]
[  ][  ][Wl][  ][Wd][  ][  ][Hu]
[  ][  ][  ][  ][  ][  ][  ][  ]
[  ][  ][  ][  ][  ][  ][  ][Ex]
