[D ][  ][  ][  ][  ][  ][  ][  ]
[B ][B ][  ][  ][  ][  ][  ][Wr]
[  ][  ][  ][  ][Hd][  ][  ][  ]
[  ][  ][  ][  ][  ][  ][  ][  ]
[  ][  ][B ][Wu][  ][  ][  ][  ]
[  ][  ][  ][B ][  ][  ][  ][  ]
[Wd][  ][  ][  ][  ][  ][  ][Wr]
[  ][  ][  ][  ][  ][  ][  ][Ex]
