[D ][  ][  ][  ][  ][Wu][  ][Hd]
[  ][  ][  ][  ][  ][  ][  ][  ]
[  ][B ][Wd][  ][  ][  ][  ][  ]
[Hu][B ][  ][  ][Wu][B ][  ][  ]
[  ][  ][  ][  ][  ][B ][  ][Hl]
[  ][  ][  ][  ][  ][Wl][  ][Hu]
[Hd][  ][  ][  ][  ][  ][  ][  ]
[  ][  ][Wd][  ][  ][  ][  ][Ex]
