[D ][  ][  ][  ][  ][  ][  ][  ]
[  ][  ][  ][  ][  ][  ][  ][  ]
[  ][  ][Hr][  ][  ][  ][Wd][Wd]
[  ][  ][  ][B ][  ][  ][  ][  ]
[  ][  ][B ][  ][  ][  ][B ][  ]
[Wr][  ][  ][  ][  ][  ][  ][  ]
[Hu][  ][Wl][  ][  ][Wr][  ][  ]
[  ][  ][  ][  ][  ][  ][  ][Ex]
