[D ][Hr][Hu][Hr][  ][B ][  ][  ]
[  ][  ][  ][  ][  ][  ][  ][  ]
[  ][Wl][  ][Wr][  ][  ][  ][  ]
[  ][  ][  ][Hr][B ][  ][  ][  ]
[  ][  ][  ][  ][  ][B ][  ][  ]
[  ][Hl][  ][Wl][  ][  ][  ][  ]
[  ][  ][Hd][  ][  ][Hr][Hd][  ]
[  ][  ][  ][  ][  ][  ][  ][Ex]
