[D ][Hr][Hu][  ][  ][Wl][  ][  ]
[  ][  ][Wd][  ][  ][  ][  ][B ]
[B ][Wl][  ][  ][  ][  ][  ][  ]
[  ][  ][  ][B ][  ][  ][  ][  ]
[  ][  ][  ][  ][  ][B ][  ][  ]
[  ][  ][  ][  ][  ][  ][  ][  ]
[  ][  ][Hd][  ][  ][  ][  ][  ]
[  ][  ][  ][  ][  ][Hr][Wu][Ex]
