[D ][  ][  ][  ][  ][  ][  ][  ]
[  ][  ][B ][  ][  ][  ][  ][  ]
[  ][  ][  ][  ][  ][  ][  ][Wd]
[  ][  ][  ][  ][  ][  ][  ][  ]
[  ][  ][  ][B ][  ][Wd][Hr][  ]
[  ][  ][  ][  ][  ][  ][  ][  ]
[  ][Wu][  ][Hu][  ][Wr][  ][  ]
[  ][  ][  ][  ][  ][  ][  ][Ex]
