[D ][  ][  ][  ][  ][  ][B ][  ]
[Wr][Wd][Wu][  ][Hr][  ][B ][  ]
[  ][  ][  ][  ][  ][  ][Hl][  ]
[  ][Hd][  ][  ][  ][  ][  ][  ]
[  ][B ][B ][B ][  ][  ][  ][  ]
[  ][  ][B ][Hu][  ][  ][Hu][  ]
[  ][  ][B ][  ][  ][  ][  ][Wl]
[  ][  ][  ][  ][  ][  ][  ][Ex]
