[D ][  ][  ][  ][  ][  ][  ][  ]
[  ][Wd][Wu][  ][  ][  ][  ][Wl]
[  ][  ][  ][  ][  ][  ][  ][  ]
[Hu][  ][  ][  ][  ][  ][Wu][  ]
[  ][  ][  ][  ][  ][  ][  ][Wr]
[  ][  ][  ][  ][  ][  ][  ][  ]
[  ][  ][  ][  ][  ][  ][  ][  ]
[Wl][  ][  ][  ][  ][  ][Hl][Ex]
