[D ][  ][  ][  ][  ][B ][Hl][  ]
[  ][  ][  ][  ][  ][  ][  ][  ]
[  ][  ][Wd][  ][  ][B ][  ][  ]
[  ][Hu][  ][Wu][  ][  ][B ][B ]
[  ][  ][  ][  ][  ][  ][  ][  ]
[  ][  ][B ][Hu][  ][  ][  ][  ]
[  ][  ][Hr][B ][  ][  ][B ][  ]
[  ][  ][  ][  ][  ][  ][Wl][Ex]
