[D ][B ][  ][  ][  ][  ][B ][  ]
[Wr][Wd][Wu][  ][Hr][  ][B ][  ]
[  ][  ][  ][  ][  ][  ][  ][  ]
[  ][Hd][  ][  ][Wu][  ][  ][  ]
[  ][  ][  ][  ][  ][  ][  ][  ]
[  ][  ][Hr][  ][  ][  ][  ][  ]
[  ][  ][  ][  ][  ][  ][  ][  ]
[  ][  ][Wu][Wr][  ][  ][  ][Ex]
