[D ][  ][  ][  ][  ][  ][B ][  ]
[Wr][  ][Wu][  ][  ][  ][Wu][Wl]
[  ][  ][  ][  ][  ][  ][Wr][  ]
[  ][  ][  ][  ][  ][  ][  ][  ]
[  ][  ][  ][  ][Wl][  ][B ][  ]
[  ][  ][  ][Wd][  ][  ][  ][  ]
[  ][  ][  ][B ][  ][Wu][  ][  ]
[Wl][  ][  ][  ][B ][  ][  ][Ex]
