[D ][  ][  ][Hr][B ][  ][  ][Hu]
[  ][  ][  ][  ][  ][Wl][  ][  ]
[Hl][  ][Wl][  ][  ][  ][  ][  ]
[  ][  ][B ][B ][  ][  ][B ][Hd]
[  ][  ][  ][  ][  ][Hu][  ][  ]
[  ][Hr][  ][  ][B ][B ][  ][  ]
[  ][  ][  ][  ][  ][  ][  ][  ]
[Wd][  ][  ][  ][Wl][  ][  ][Ex]
