[D ][  ][  ][  ][  ][  ][  ][  ]
[  ][  ][  ][  ][  ][  ][  ][Wr]
[  ][  ][  ][  ][Hd][  ][  ][  ]
[  ][  ][Hd][  ][  ][  ][B ][B ]
[B ][  ][  ][Hu][  ][  ][Wr][  ]
[  ][Hr][  ][  ][  ][  ][  ][  ]
[Wd][  ][  ][  ][  ][  ][  ][  ]
[  ][  ][  ][Wd][  ][B ][  ][Ex]
