[D ][  ][B ][  ][  ][  ][  ][  ]
[Hl][  ][  ][  ][  ][  ][  ][  ]
[Wr][  ][  ][  ][  ][  ][  ][  ]
[  ][  ][Hu][  ][  ][  ][  ][  ]
[  ][  ][Wr][B ][  ][  ][  ][  ]
[B ][  ][  ][  ][B ][  ][Hr][  ]
[  ][  ][  ][  ][  ][Wr][  ][  ]
[B ][  ][  ][  ][  ][  ][  ][Ex]
