[D ][  ][  ][  ][B ][Wu][  ][  ]
[  ][  ][  ][  ][  ][  ][  ][  ]
[B ][  ][B ][  ][  ][  ][  ][Wl]
[  ][  ][  ][  ][  ][  ][B ][Hl]
[  ][  ][  ][  ][  ][Hu][  ][  ]
[  ][B ][Hr][  ][B ][B ][  ][  ]
[  ][  ][Hd][  ][  ][Hl][Wl][Hr]
[  ][  ][Wl][  ][Wl][Wu][  ][Ex]
