[D ][  ][  ][  ][B ][Hu][  ][  ]
[  ][  ][  ][  ][  ][  ][Hu][  ]
[Wr][  ][  ][  ][Hd][  ][  ][  ]
[  ][  ][  ][  ][  ][  ][B ][  ]
[Hu][  ][Hu][  ][  ][Hu][  ][  ]
[  ][  ][  ][  ][B ][  ][  ][  ]
[  ][  ][  ][  ][  ][  ][  ][  ]
[  ][B ][  ][  ][  ][  ][  ][Ex]
