[D ][  ][  ][  ][  ][  ][  ][  ]
[B ][  ][Wu][  ][  ][  ][  ][  ]
[Wl][  ][  ][  ][Hl][  ][  ][  ]
[Hl][  ][  ][B ][  ][  ][Wd][  ]
[  ][Wu][  ][B ][  ][Wl][  ][  ]
[Wd][  ][  ][  ][  ][  ][  ][  ]
[Wd][  ][  ][Hu][  ][  ][B ][  ]
[  ][  ][Wu][  ][  ][  ][  ][Ex]
