[D ][  ][  ][Wl][  ][  ][  ][Wr]
[  ][  ][  ][  ][  ][  ][  ][Wl]
[Wr][  ][  ][  ][  ][  ][  ][  ]
[  ][  ][  ][  ][  ][  ][Wl][  ]
[  ][  ][  ][  ][  ][  ][  ][B ]
[Hu][  ][  ][  ][B ][  ][  ][  ]
[Wu][  ][  ][  ][  ][  ][  ][  ]
[  ][  ][  ][  ][  ][  ][  ][Ex]
