[D ][  ][  ][  ][  ][  ][B ][  ]
[Wr][Wd][Wu][  ][  ][  ][Wu][Wl]
[  ][  ][  ][  ][  ][Wl][Wr][  ]
[  ][  ][  ][  ][  ][  ][  ][  ]
[  ][  ][Wu][  ][  ][  ][Hu][  ]
[  ][  ][  ][  ][  ][  ][  ][  ]
[  ][  ][  ][  ][  ][  ][  ][  ]
[Wl][  ][  ][  ][  ][  ][Hl][Ex]
