[D ][Hr][  ][  ][  ][Hu][  ][  ]
[  ][  ][Wu][B ][  ][  ][Wu][B ]
[  ][  ][  ][  ][Hd][  ][  ][  ]
[B ][  ][B ][  ][  ][  ][  ][  ]
[  ][  ][Hu][  ][  ][B ][  ][  ]
[  ][  ][  ][  ][  ][  ][  ][  ]
[  ][  ][B ][  ][  ][  ][  ][  ]
[Wl][  ][  ][  ][  ][  ][  ][Ex]
