[D ][  ][  ][  ][B ][Wd][Hd][  ]
[  ][Hr][Hr][  ][  ][  ][  ][  ]
[  ][  ][  ][Wl][  ][B ][B ][  ]
[  ][  ][  ][B ][  ][  ][B ][B ]
[  ][  ][Wl][B ][  ][  ][Hl][Hl]
[Hd][  ][B ][  ][B ][  ][  ][  ]
[  ][  ][Wl][  ][B ][Wr][  ][Wr]
[  ][  ][  ][Hu][  ][  ][  ][Ex]
