[D ][  ][  ][  ][B ][  ][  ][Hu]
[  ][  ][Hd][  ][  ][  ][  ][  ]
[  ][  ][  ][  ][  ][Hl][  ][B ]
[  ][  ][  ][  ][  ][  ][B ][  ]
[  ][  ][Hd][  ][Wr][Hu][  ][  ]
[Wl][  ][  ][  ][  ][B ][  ][  ]
[  ][  ][  ][  ][  ][  ][B ][  ]
[  ][B ][B ][  ][  ][  ][B ][Ex]
