[D ][  ][  ][  ][B ][Wu][  ][  ]
[  ][  ][  ][  ][  ][  ][  ][Hu]
[B ][  ][  ][  ][  ][  ][  ][  ]
[  ][  ][  ][  ][  ][  ][B ][  ]
[  ][  ][  ][  ][  ][Hu][  ][  ]
[  ][  ][  ][  ][B ][B ][  ][  ]
[  ][  ][Hd][  ][  ][Hl][Wl][  ]
[  ][  ][  ][  ][Wl][  ][  ][Ex]
