[D ][  ][Wu][  ][  ][  ][  ][Hu]
[Hl][  ][  ][  ][  ][  ][B ][  ]
[Wr][  ][  ][  ][  ][  ][  ][  ]
[  ][  ][  ][  ][  ][Hu][  ][  ]
[  ][  ][Wr][  ][  ][  ][Hl][  ]
[Hr][  ][  ][  ][B ][  ][  ][  ]
[  ][  ][Wd][  ][  ][  ][  ][  ]
[B ][  ][  ][  ][  ][  ][  ][Ex]
