[D ][  ][  ][  ][  ][  ][B ][  ]
[Wr][  ][Wu][  ][  ][  ][Wu][Wl]
[B ][  ][  ][  ][  ][  ][  ][  ]
[Hu][  ][  ][  ][B ][  ][  ][  ]
[  ][  ][Wu][Wr][Wl][B ][  ][  ]
[  ][B ][  ][  ][  ][  ][  ][  ]
[  ][Hd][  ][  ][  ][Wu][  ][  ]
[Wl][  ][  ][  ][  ][  ][Hl][Ex]
