[D ][  ][  ][  ][  ][  ][B ][  ]
[Wr][Wd][  ][  ][  ][  ][Wu][  ]
[  ][  ][  ][  ][  ][Wl][Wr][  ]
[  ][  ][  ][  ][  ][  ][  ][B ]
[  ][  ][  ][  ][Wd][  ][B ][  ]
[  ][  ][  ][  ][  ][B ][  ][  ]
[  ][  ][  ][  ][  ][Wu][  ][  ]
[Wl][  ][  ][  ][  ][  ][  ][Ex]
