[D ][Wu][  ][  ][  ][  ][B ][  ]
[Wr][Wd][Wu][  ][  ][  ][Wu][  ]
[  ][  ][Wl][  ][  ][  ][  ][  ]
[  ][  ][  ][  ][  ][  ][  ][  ]
[  ][  ][Wu][B ][Wl][  ][  ][  ]
[  ][  ][  ][  ][  ][  ][  ][  ]
[  ][  ][  ][  ][  ][Wu][  ][  ]
[  ][  ][  ][  ][  ][  ][  ][Ex]
