[D ][  ][  ][  ][Wl][B ][  ][  ]
[  ][B ][Hr][  ][  ][  ][  ][  ]
[  ][  ][  ][  ][  ][B ][  ][  ]
[Wl][  ][  ][  ][  ][  ][B ][B ]
[  ][  ][Wl][B ][  ][  ][Hl][Hl]
[B ][Hr][B ][  ][B ][  ][  ][  ]
[  ][  ][  ][  ][B ][  ][  ][Wr]
[  ][  ][  ][Hu][  ][  ][  ][Ex]
