[D ][  ][B ][  ][  ][  ][  ][Hu]
[  ][  ][  ][  ][  ][Wl][  ][Wd]
[  ][  ][B ][  ][  ][  ][  ][  ]
[  ][  ][  ][  ][  ][Hu][  ][  ]
[  ][  ][Wr][Hu][  ][  ][  ][  ]
[Hr][  ][Wl][  ][B ][  ][  ][  ]
[  ][  ][  ][  ][  ][  ][  ][  ]
[B ][B ][  ][  ][  ][  ][  ][Ex]
