[D ][  ][  ][  ][  ][Wu][  ][  ]
[  ][  ][Wr][  ][  ][Wl][B ][  ]
[  ][  ][  ][  ][Hu][  ][  ][  ]
[  ][  ][  ][B ][  ][  ][  ][  ]
[  ][  ][  ][  ][  ][Hu][  ][  ]
[  ][  ][  ][  ][Wd][  ][  ][Hr]
[  ][  ][B ][  ][Hd][  ][  ][  ]
[  ][  ][  ][  ][Wl][  ][  ][Ex]
