[D ][  ][B ][  ][  ][  ][  ][Hu]
[Hl][  ][  ][  ][  ][  ][  ][  ]
[Wr][Hd][  ][  ][  ][  ][  ][  ]
[  ][  ][  ][  ][  ][  ][  ][  ]
[  ][  ][Wr][  ][  ][  ][Hl][  ]
[Hr][  ][  ][  ][B ][  ][  ][  ]
[  ][  ][  ][  ][  ][  ][  ][  ]
[  ][B ][  ][  ][  ][  ][  ][Ex]
