[D ][  ][  ][  ][Wl][  ][  ][  ]
[  ][B ][Hr][  ][  ][  ][  ][  ]
[  ][  ][  ][  ][  ][B ][  ][  ]
[Wl][  ][  ][  ][  ][  ][B ][B ]
[  ][  ][Wl][B ][  ][  ][Hl][Hl]
[B ][Hr][B ][  ][B ][  ][  ][B ]
[  ][  ][  ][  ][Hd][  ][  ][  ]
[  ][  ][  ][Hu][  ][  ][  ][Ex]
