[D ][  ][B ][B ][  ][Wl][B ][  ]
[Hl][  ][  ][  ][  ][  ][  ][  ]
[  ][  ][  ][  ][  ][  ][  ][B ]
[  ][  ][  ][  ][  ][Hu][  ][B ]
[  ][Hd][B ][  ][  ][Wd][  ][Wl]
[  ][  ][B ][  ][B ][  ][  ][  ]
[  ][  ][  ][  ][  ][  ][  ][  ]
[  ][B ][  ][Wd][  ][  ][  ][Ex]
