[D ][  ][  ][  ][  ][B ][  ][  ]
[  ][Wd][Hr][  ][  ][  ][  ][  ]
[Hu][B ][  ][  ][  ][  ][  ][  ]
[  ][B ][  ][  ][  ][  ][B ][  ]
[  ][  ][  ][  ][  ][  ][  ][  ]
[  ][Hr][  ][Hr][B ][  ][  ][  ]
[  ][Hu][Wl][  ][Wu][  ][Wr][Wr]
[  ][Wl][  ][Hr][B ][  ][  ][Ex]
