[D ][  ][  ][  ][  ][  ][  ][  ][  ][  ][  ][  ][  ][  ][  ][  ]
[  ][Hd][  ][  ][  ][  ][Wu][  ][  ][  ][  ][Hd][  ][  ][  ][  ]
[  ][  ][Hl][  ][  ][  ][  ][Wu][  ][  ][  ][B ][  ][Hu][  ][  ]
[B ][  ][  ][Wr][  ][  ][  ][  ][  ][  ][  ][  ][  ][  ][  ][  ]
[B ][B ][  ][  ][  ][  ][  ][  ][  ][  ][  ][  ][Wl][  ][  ][Wr]
[B ][  ][  ][  ][  ][  ][  ][  ][  ][  ][  ][  ][Wu][  ][  ][  ]
[  ][  ][  ][B ][  ][B ][Wr][  ][  ][  ][  ][  ][  ][B ][  ][  ]
[  ][  ][  ][  ][  ][  ][  ][  ][  ][  ][  ][  ][  ][  ][  ][  ]
[  ][  ][B ][B ][  ][  ][Hu][  ][  ][  ][Wl][  ][  ][  ][  ][Ex]
