[  ][Ex][  ][  ][  ][  ][  ][  ][B ][  ][  ][  ][Wd][  ][  ][  ]
[  ][  ][Hl][  ][  ][  ][  ][B ][  ][  ][  ][D ][  ][  ][  ][Hl]
[  ][  ][  ][  ][Wd][  ][  ][  ][  ][  ][  ][  ][  ][B ][  ][Wl]
[  ][  ][  ][Wd][  ][  ][  ][  ][  ][  ][  ][  ][  ][  ][  ][  ]
[  ][  ][  ][  ][  ][  ][Hl][Hd][Wu][  ][  ][  ][  ][  ][  ][  ]
[  ][  ][  ][Wr][  ][Wl][Wl][B ][  ][  ][  ][  ][  ][  ][  ][  ]
[Hu][  ][Hr][Hl][B ][  ][  ][  ][  ][  ][  ][B ][Wd][  ][  ][Wu]
[  ][  ][  ][  ][  ][  ][Wu][  ][  ][  ][  ][  ][  ][  ][  ][  ]
[  ][Wl][  ][  ][  ][B ][  ][Wd][  ][  ][B ][Wd][  ][  ][  ][  ]
