[  ][Ex][  ][B ][  ][Wl][Hr][B ][B ][  ][  ][Wu][Wd][B ][  ][  ]
[  ][  ][  ][  ][  ][  ][B ][  ][Hd][  ][  ][D ][Hd][  ][  ][  ]
[  ][  ][  ][  ][  ][  ][Wl][  ][  ][Wr][  ][  ][  ][B ][  ][  ]
[  ][  ][  ][Wd][  ][  ][  ][  ][  ][  ][Hu][  ][  ][  ][  ][  ]
[B ][Wu][  ][  ][  ][  ][B ][Hr][  ][  ][Hr][Wd][  ][Hu][B ][  ]
[  ][  ][  ][  ][  ][  ][  ][  ][  ][  ][Wl][  ][  ][  ][  ][  ]
[  ][  ][Hr][Hl][Hl][B ][  ][  ][  ][  ][  ][B ][  ][  ][  ][Hu]
[  ][  ][  ][  ][  ][  ][  ][  ][B ][B ][  ][Wl][Wd][  ][  ][Hl]
[  ][  ][  ][  ][  ][  ][  ][Wd][  ][  ][B ][Wd][  ][  ][  ][  ]
