[  ][Ex][  ][B ][  ][  ][Hr][  ][B ][  ][  ][  ][Wd][  ][  ][  ]
[  ][  ][  ][  ][  ][  ][B ][B ][  ][  ][  ][D ][Hd][  ][B ][  ]
[  ][  ][  ][  ][  ][  ][  ][  ][  ][  ][  ][  ][  ][B ][  ][Wl]
[  ][  ][  ][Wd][  ][  ][  ][  ][  ][  ][  ][  ][  ][  ][  ][  ]
[B ][  ][  ][  ][  ][  ][B ][Hr][  ][  ][Hr][  ][  ][Hu][  ][  ]
[  ][  ][  ][  ][  ][Wr][  ][  ][  ][  ][B ][  ][  ][  ][  ][  ]
[  ][  ][Hr][Hl][Hl][  ][  ][Hu][  ][  ][  ][B ][  ][  ][  ][Hu]
[  ][  ][  ][  ][  ][  ][  ][  ][B ][  ][  ][  ][Wd][  ][  ][  ]
[  ][Wl][Hr][  ][  ][B ][  ][Wd][  ][  ][B ][Wd][  ][  ][  ][  ]
