[  ][Ex][Wl][  ][  ][  ][  ][  ][  ][  ][  ][  ][Wd][B ][  ][  ]
[  ][  ][  ][B ][  ][  ][  ][Hu][Hd][  ][  ][D ][  ][B ][  ][Hl]
[  ][  ][  ][  ][  ][  ][  ][  ][Wu][  ][  ][  ][  ][B ][  ][Wl]
[  ][Wu][  ][Wd][  ][  ][  ][  ][  ][  ][  ][  ][Hr][  ][  ][  ]
[  ][  ][  ][B ][  ][  ][B ][Hd][Wu][  ][  ][  ][  ][  ][  ][  ]
[  ][Wr][  ][Wr][  ][Wl][Wl][Hr][B ][  ][  ][  ][Wu][  ][  ][  ]
[Hu][  ][  ][  ][B ][B ][  ][  ][  ][  ][  ][B ][Wl][  ][  ][Wu]
[Hu][  ][Hd][  ][  ][  ][Wu][B ][  ][  ][  ][  ][  ][  ][  ][  ]
[  ][Wu][  ][  ][  ][  ][  ][Wd][  ][  ][B ][  ][Wu][  ][  ][  ]
