[  ][Ex][  ][  ][B ][  ][  ][  ][  ][  ][  ][  ][Wl][  ][  ][Hl]
[  ][  ][B ][  ][  ][  ][  ][  ][  ][B ][Wr][D ][  ][Wd][  ][  ]
[  ][  ][  ][  ][  ][  ][  ][  ][  ][  ][  ][  ][  ][  ][Hu][  ]
[  ][  ][  ][  ][  ][  ][  ][  ][  ][  ][  ][Wl][B ][B ][  ][  ]
[  ][  ][  ][  ][  ][  ][  ][Hd][  ][  ][  ][B ][  ][B ][Wu][  ]
[Hl][  ][  ][  ][B ][Hu][  ][  ][  ][  ][  ][  ][Hu][  ][  ][  ]
[  ][  ][  ][  ][  ][  ][  ][  ][Hr][  ][Wr][  ][  ][  ][  ][  ]
[  ][  ][  ][  ][  ][Wd][  ][  ][  ][  ][  ][  ][  ][  ][  ][  ]
[  ][B ][B ][  ][  ][  ][  ][  ][Wd][  ][  ][  ][  ][  ][  ][  ]
