[  ][Ex][  ][  ][B ][B ][  ][  ][  ][  ][  ][  ][Wl][  ][  ][Wd]
[  ][  ][  ][  ][  ][  ][  ][Wu][  ][Wl][Wr][D ][  ][Wd][  ][  ]
[  ][  ][  ][  ][  ][  ][Hu][  ][  ][Hd][B ][  ][B ][  ][  ][Wu]
[  ][  ][  ][  ][  ][  ][  ][  ][  ][  ][  ][Wl][B ][B ][  ][  ]
[  ][  ][  ][  ][  ][  ][  ][  ][  ][  ][  ][B ][  ][B ][B ][  ]
[  ][  ][  ][  ][  ][  ][  ][  ][  ][  ][B ][  ][Hd][B ][  ][  ]
[  ][  ][  ][  ][  ][  ][  ][  ][Hu][  ][  ][Hu][  ][Hl][  ][  ]
[  ][  ][  ][  ][  ][  ][  ][  ][  ][  ][  ][  ][  ][  ][Wr][  ]
[  ][Hr][  ][  ][  ][Hd][  ][  ][Wd][  ][  ][  ][  ][  ][  ][  ]
