[  ][Ex][  ][B ][  ][Wl][Hr][  ][  ][Hr][  ][Wu][Wd][  ][  ][  ]
[  ][  ][  ][  ][  ][  ][B ][Hl][Hd][  ][Hr][D ][Hd][  ][B ][  ]
[  ][  ][  ][  ][  ][  ][Wl][  ][  ][Wr][  ][  ][  ][B ][  ][  ]
[  ][  ][  ][  ][  ][  ][  ][  ][  ][  ][Hu][  ][  ][  ][  ][  ]
[B ][Wu][  ][  ][  ][  ][B ][Hr][  ][  ][  ][Wd][  ][Hu][B ][  ]
[  ][  ][  ][  ][  ][  ][  ][  ][  ][  ][Wl][  ][  ][  ][  ][  ]
[  ][  ][Hr][Hl][Hl][B ][  ][Hu][  ][  ][  ][  ][  ][  ][  ][Hu]
[  ][  ][  ][  ][  ][  ][  ][B ][B ][  ][  ][Wl][Wd][  ][  ][Hl]
[  ][  ][  ][  ][  ][B ][  ][Wd][  ][  ][B ][Wd][  ][  ][  ][  ]
