[  ][Ex][  ][B ][  ][  ][Hr][  ][B ][B ][  ][  ][Wd][  ][  ][  ]
[  ][  ][  ][  ][  ][B ][B ][B ][  ][  ][  ][D ][Hd][  ][  ][Hl]
[  ][  ][  ][  ][Wd][  ][  ][  ][  ][  ][  ][  ][  ][B ][  ][Wl]
[  ][  ][  ][Wd][  ][  ][  ][  ][  ][  ][  ][  ][  ][  ][  ][  ]
[  ][  ][  ][  ][  ][  ][B ][Hr][  ][  ][Hr][  ][  ][  ][  ][Wu]
[  ][  ][  ][Hl][  ][Wr][Wl][B ][  ][  ][B ][  ][  ][  ][  ][  ]
[Hu][  ][Hr][Hl][Hl][  ][  ][Hu][  ][  ][  ][B ][Wl][  ][  ][Wr]
[  ][  ][  ][  ][  ][  ][Wu][  ][  ][  ][  ][  ][Wd][  ][  ][  ]
[  ][Wl][Hr][  ][  ][B ][  ][  ][  ][  ][  ][Wd][  ][  ][  ][  ]
