[  ][Ex][Hr][  ][  ][  ][  ][  ][  ][  ][  ][  ][  ][  ][  ][Hl]
[  ][Wr][Hl][  ][  ][  ][  ][  ][  ][  ][  ][D ][B ][  ][  ][  ]
[  ][  ][  ][  ][  ][  ][B ][  ][  ][  ][  ][  ][  ][  ][  ][Wu]
[  ][  ][  ][  ][  ][  ][  ][  ][  ][B ][  ][Wl][  ][  ][  ][  ]
[  ][B ][  ][  ][  ][  ][  ][  ][  ][  ][B ][B ][  ][  ][  ][  ]
[Hu][  ][  ][  ][  ][B ][B ][  ][  ][  ][B ][  ][  ][  ][  ][  ]
[  ][  ][  ][Hl][  ][  ][  ][  ][  ][  ][B ][  ][Wd][B ][  ][B ]
[  ][  ][  ][  ][  ][  ][Wu][  ][  ][  ][  ][  ][  ][  ][  ][  ]
[  ][  ][  ][  ][  ][  ][  ][  ][  ][  ][B ][Wd][  ][  ][Wl][  ]
