[  ][Ex][Wu][  ][  ][Wl][Wl][  ][  ][  ][  ][  ][Wd][  ][  ][  ]
[  ][  ][  ][  ][  ][  ][B ][  ][  ][  ][  ][D ][Hd][B ][  ][  ]
[  ][Wl][  ][  ][Hu][  ][Wl][  ][  ][Wr][  ][  ][  ][  ][  ][  ]
[  ][  ][  ][Wd][  ][  ][  ][  ][  ][  ][  ][  ][  ][  ][  ][  ]
[B ][  ][  ][  ][  ][  ][B ][Hr][Hd][  ][Hd][  ][  ][Hu][  ][  ]
[  ][  ][  ][  ][B ][  ][B ][  ][Wr][  ][  ][B ][  ][B ][  ][  ]
[B ][B ][Hr][Hl][  ][B ][  ][  ][  ][  ][  ][B ][  ][  ][  ][B ]
[  ][  ][B ][  ][B ][  ][  ][  ][B ][  ][  ][Wl][  ][  ][  ][Hl]
[  ][  ][Hr][  ][  ][  ][  ][  ][  ][  ][  ][Wd][  ][B ][  ][  ]
