[B ][Ex][  ][  ][  ][Wl][Wl][  ][B ][  ][  ][  ][  ][  ][  ][  ]
[  ][  ][  ][B ][  ][  ][  ][  ][Hd][  ][  ][D ][Hd][B ][  ][  ]
[  ][  ][  ][  ][Hu][  ][Wl][  ][  ][Wr][  ][  ][  ][  ][  ][  ]
[  ][  ][  ][Wl][  ][  ][  ][  ][  ][  ][Wu][  ][  ][  ][B ][  ]
[B ][Wu][  ][  ][  ][  ][B ][B ][  ][  ][Hr][  ][  ][B ][B ][  ]
[  ][  ][  ][  ][  ][Wr][B ][  ][  ][  ][Wl][  ][  ][B ][  ][  ]
[B ][  ][Hr][B ][Hl][B ][  ][  ][  ][  ][  ][B ][Wu][  ][  ][  ]
[  ][  ][B ][Wr][B ][  ][  ][  ][  ][  ][  ][Wl][Wd][  ][  ][  ]
[B ][Hr][  ][  ][  ][  ][  ][Wd][  ][  ][B ][B ][  ][B ][  ][  ]
