[  ][Ex][Wu][  ][  ][Wl][Wl][  ][  ][  ][  ][  ][Wd][  ][  ][  ]
[  ][  ][  ][  ][  ][  ][B ][  ][  ][  ][  ][D ][Hd][B ][  ][  ]
[  ][Wl][  ][  ][Hu][  ][Wl][  ][  ][Wr][  ][  ][  ][  ][  ][  ]
[  ][  ][  ][Wd][  ][  ][  ][  ][  ][  ][  ][  ][  ][  ][  ][  ]
[B ][Wu][  ][  ][  ][  ][B ][Hr][Hd][  ][Hd][  ][  ][Hu][  ][  ]
[  ][  ][  ][  ][  ][  ][B ][  ][Wr][  ][Wl][  ][  ][B ][  ][  ]
[B ][B ][Hr][Hl][  ][B ][  ][  ][  ][  ][  ][B ][  ][  ][  ][B ]
[  ][  ][B ][  ][B ][  ][  ][  ][B ][  ][  ][Wl][Wd][  ][  ][Hl]
[  ][  ][Hr][  ][  ][  ][  ][  ][  ][  ][  ][Wd][  ][B ][  ][  ]
