[  ][Ex][  ][  ][  ][  ][  ][  ][  ][  ][  ][  ][  ][  ][  ][  ]
[  ][Wu][Hu][B ][  ][  ][  ][  ][  ][B ][Wr][D ][B ][Wr][  ][  ]
[  ][  ][  ][Hl][  ][  ][B ][  ][  ][  ][  ][  ][  ][  ][  ][  ]
[  ][  ][  ][  ][  ][  ][  ][  ][  ][B ][  ][Wl][Hl][  ][  ][  ]
[  ][  ][  ][  ][  ][  ][  ][Hd][  ][  ][  ][B ][Hu][  ][  ][  ]
[Hl][  ][  ][  ][  ][  ][  ][  ][  ][  ][B ][  ][B ][Wl][  ][Hr]
[  ][  ][Hd][Hl][  ][  ][  ][B ][Hr][  ][  ][  ][Wd][B ][  ][B ]
[  ][  ][  ][  ][Hu][  ][Wd][  ][  ][B ][  ][Wu][  ][Wl][  ][  ]
[  ][  ][  ][Wd][B ][Wu][  ][B ][Hr][  ][  ][Wd][  ][  ][Wl][  ]
