[  ][Ex][  ][  ][  ][  ][  ][  ][B ][  ][  ][  ][Wd][B ][  ][  ]
[  ][  ][  ][  ][  ][  ][B ][B ][Hu][  ][  ][D ][  ][  ][  ][Hl]
[  ][  ][  ][  ][  ][  ][  ][  ][  ][  ][  ][  ][  ][B ][  ][Wl]
[  ][Wu][  ][Wd][  ][  ][  ][  ][  ][  ][  ][  ][  ][  ][  ][  ]
[  ][  ][  ][  ][  ][  ][B ][Hd][Wu][  ][  ][  ][  ][  ][  ][  ]
[  ][Wr][  ][Wr][  ][Wl][Wl][B ][  ][  ][  ][  ][  ][  ][  ][  ]
[Hu][  ][  ][Hl][B ][  ][  ][  ][  ][  ][  ][B ][Wd][  ][  ][Wu]
[  ][  ][Hd][  ][  ][  ][Wu][  ][  ][  ][  ][  ][  ][  ][  ][  ]
[  ][Wl][  ][  ][  ][  ][  ][Wd][  ][  ][B ][Wd][Wu][  ][  ][  ]
