[  ][Ex][  ][  ][B ][B ][  ][  ][  ][  ][  ][  ][Wl][  ][  ][Wd]
[Hd][  ][  ][  ][  ][  ][  ][Wu][  ][Wl][Wr][D ][  ][Wd][Wu][  ]
[  ][  ][  ][  ][  ][  ][Hu][  ][  ][Hd][Wl][  ][  ][  ][  ][  ]
[  ][  ][  ][  ][  ][  ][  ][  ][  ][  ][  ][Wl][B ][B ][  ][  ]
[  ][  ][  ][  ][  ][  ][  ][  ][  ][  ][  ][B ][  ][B ][  ][  ]
[  ][  ][  ][  ][  ][  ][  ][  ][  ][  ][B ][B ][  ][B ][  ][  ]
[  ][  ][  ][Hr][  ][  ][  ][  ][  ][  ][  ][Hu][  ][Hl][  ][  ]
[  ][Wu][  ][  ][  ][Wd][  ][  ][  ][  ][  ][  ][  ][  ][Wr][  ]
[  ][Hr][  ][  ][  ][Hd][  ][  ][Wd][  ][  ][  ][  ][  ][  ][  ]
