[Wl][Ex][  ][  ][  ][  ][  ][  ][B ][  ][Hl][  ][  ][  ][  ][  ]
[  ][  ][  ][  ][Wu][  ][  ][  ][  ][  ][  ][D ][  ][Wd][  ][  ]
[Hl][  ][  ][  ][Hu][  ][B ][  ][  ][  ][  ][B ][  ][  ][  ][  ]
[  ][  ][  ][  ][Hr][B ][  ][  ][  ][  ][  ][  ][  ][  ][Wl][Hr]
[  ][  ][  ][  ][  ][  ][B ][  ][Hu][  ][  ][  ][  ][  ][  ][  ]
[  ][  ][  ][  ][  ][  ][  ][  ][  ][  ][Wl][  ][  ][  ][  ][  ]
[  ][  ][Wu][  ][  ][  ][Hr][  ][  ][  ][  ][  ][  ][  ][  ][B ]
[  ][  ][  ][  ][  ][  ][  ][  ][  ][  ][  ][  ][  ][  ][  ][  ]
[Wu][  ][  ][Hd][  ][  ][Wd][  ][  ][  ][  ][B ][  ][  ][Hu][  ]
