[  ][Ex][  ][B ][  ][Wl][Hr][B ][B ][  ][  ][Wu][Wd][  ][  ][  ]
[  ][  ][  ][  ][  ][  ][B ][Hl][Hd][  ][  ][D ][Hd][  ][  ][  ]
[  ][  ][  ][  ][  ][  ][Wl][  ][  ][Wr][  ][  ][  ][B ][  ][  ]
[  ][  ][  ][Wd][  ][  ][  ][  ][  ][  ][Hu][  ][  ][  ][  ][  ]
[B ][Wu][  ][  ][  ][  ][B ][Hr][  ][  ][Hr][Wd][  ][Hu][B ][  ]
[  ][  ][  ][  ][  ][Wr][  ][  ][  ][  ][Wl][  ][  ][  ][  ][  ]
[  ][  ][Hr][Hl][Hl][B ][  ][  ][  ][  ][  ][B ][  ][  ][  ][Hu]
[  ][  ][  ][  ][  ][  ][  ][  ][B ][  ][  ][Wl][Wd][  ][  ][Hl]
[  ][  ][  ][  ][  ][  ][  ][Wd][  ][  ][B ][Wd][  ][  ][  ][  ]
