[  ][Ex][  ][  ][  ][  ][  ][  ][  ][  ][Hu][  ][  ][  ][  ][  ]
[  ][  ][  ][  ][  ][  ][  ][Wu][  ][B ][Wr][D ][  ][Wd][  ][  ]
[  ][  ][  ][  ][  ][  ][Hu][  ][  ][Hd][B ][  ][B ][  ][  ][  ]
[Wu][  ][  ][  ][  ][  ][  ][  ][  ][  ][  ][Wl][B ][B ][  ][  ]
[  ][  ][  ][  ][  ][  ][  ][  ][  ][  ][  ][B ][  ][B ][B ][  ]
[Hl][  ][  ][  ][  ][  ][  ][  ][  ][  ][  ][  ][  ][B ][  ][  ]
[  ][  ][  ][Hr][  ][  ][  ][  ][  ][  ][  ][Hu][  ][  ][  ][  ]
[  ][  ][  ][  ][  ][Wd][  ][  ][  ][  ][  ][  ][  ][  ][Hl][  ]
[  ][Wd][  ][  ][  ][Hd][  ][  ][Wd][  ][  ][  ][  ][  ][  ][  ]
