[  ][Ex][  ][  ][  ][  ][  ][  ][  ][  ][  ][B ][  ][  ][  ][Hl]
[  ][Wr][B ][  ][  ][  ][  ][  ][  ][B ][Wr][D ][  ][  ][  ][  ]
[  ][  ][  ][  ][  ][  ][  ][  ][  ][  ][  ][  ][  ][  ][  ][  ]
[  ][  ][  ][  ][Hu][  ][Wl][  ][Hd][  ][  ][Wl][Hl][B ][  ][  ]
[  ][  ][  ][  ][Wu][  ][  ][Hd][  ][  ][  ][B ][  ][  ][  ][  ]
[Hl][  ][Hr][  ][  ][  ][B ][  ][  ][Hu][  ][Wr][  ][Wl][  ][Hr]
[  ][  ][Hd][  ][Wl][  ][  ][  ][Hr][  ][Wr][  ][Wd][  ][  ][B ]
[  ][  ][  ][  ][  ][Wd][  ][Wu][  ][  ][  ][  ][  ][  ][  ][  ]
[  ][B ][Hu][  ][  ][  ][  ][  ][Hr][  ][B ][  ][  ][  ][Wl][  ]
