[  ][Ex][  ][  ][  ][  ][  ][  ][  ][  ][  ][  ][Wd][B ][  ][  ]
[  ][  ][Hl][  ][  ][  ][B ][  ][Hu][  ][  ][D ][B ][  ][  ][B ]
[  ][  ][  ][  ][  ][  ][  ][  ][  ][  ][  ][  ][  ][  ][  ][B ]
[  ][  ][  ][Wd][  ][  ][  ][  ][  ][  ][  ][  ][  ][  ][  ][  ]
[  ][  ][  ][  ][  ][  ][B ][Hd][  ][  ][B ][B ][  ][  ][  ][  ]
[  ][  ][  ][  ][  ][  ][Wl][  ][  ][  ][B ][  ][  ][Wl][  ][  ]
[  ][  ][  ][Hl][B ][  ][  ][B ][  ][  ][  ][  ][Wd][  ][  ][B ]
[  ][  ][  ][  ][  ][  ][Wu][  ][  ][  ][  ][  ][  ][  ][  ][  ]
[  ][Wl][  ][Wd][  ][  ][  ][  ][Hu][  ][B ][Wd][  ][  ][  ][  ]
