[  ][Ex][  ][  ][  ][  ][  ][  ][  ][  ][  ][B ][  ][  ][  ][Hl]
[  ][  ][  ][  ][  ][  ][  ][  ][  ][B ][Wr][D ][  ][Wr][  ][  ]
[  ][Wr][  ][  ][  ][  ][  ][  ][  ][  ][  ][  ][  ][  ][  ][  ]
[  ][  ][  ][  ][Hu][  ][  ][  ][Hd][  ][  ][Wl][Hl][B ][Wr][  ]
[  ][  ][  ][  ][Wu][  ][  ][Hd][  ][  ][  ][B ][  ][  ][  ][  ]
[Hl][  ][  ][  ][  ][  ][B ][  ][  ][  ][  ][  ][B ][Wl][  ][Hr]
[  ][  ][Hd][  ][  ][  ][  ][  ][Hr][  ][  ][  ][Wd][  ][  ][B ]
[  ][  ][  ][  ][  ][Wd][  ][  ][  ][  ][  ][Wu][  ][Wl][  ][  ]
[  ][B ][  ][  ][  ][Wu][  ][  ][Hr][  ][  ][  ][  ][  ][Wl][  ]
