[  ][Ex][  ][  ][B ][  ][  ][  ][  ][  ][  ][  ][Wl][B ][Wd][Hu]
[  ][  ][B ][  ][  ][  ][  ][  ][  ][B ][Wd][D ][  ][Wd][  ][  ]
[  ][  ][  ][  ][  ][  ][  ][B ][  ][  ][  ][  ][  ][  ][Hr][  ]
[  ][  ][B ][  ][Wu][  ][B ][  ][  ][  ][  ][Wl][  ][B ][  ][  ]
[  ][Wd][  ][  ][  ][  ][B ][  ][B ][  ][  ][B ][B ][B ][Wu][  ]
[B ][  ][Wu][  ][B ][B ][  ][  ][  ][B ][Hr][  ][Hu][Wu][  ][Hd]
[  ][  ][  ][  ][  ][Hl][Wd][  ][  ][  ][Wr][B ][  ][  ][  ][  ]
[  ][  ][Hd][B ][  ][Hr][  ][  ][  ][  ][  ][  ][  ][  ][  ][  ]
[  ][  ][B ][Wu][  ][Hd][  ][Hu][Wd][  ][  ][  ][  ][  ][  ][B ]
