[  ][Ex][  ][  ][B ][  ][  ][  ][  ][  ][  ][B ][  ][  ][  ][Hl]
[  ][  ][B ][  ][  ][  ][  ][  ][  ][B ][Wr][D ][  ][Wr][  ][  ]
[  ][  ][  ][  ][  ][  ][  ][  ][  ][  ][  ][  ][  ][  ][Hd][  ]
[  ][  ][  ][  ][Hu][  ][Wl][  ][Hd][  ][  ][Wl][Hl][B ][  ][  ]
[  ][  ][  ][  ][Hr][  ][  ][Hd][  ][  ][  ][B ][  ][  ][Wu][  ]
[Hl][  ][Hr][  ][  ][  ][B ][  ][  ][  ][  ][  ][B ][Wl][  ][Hr]
[  ][  ][Hd][  ][Wl][  ][  ][  ][Hr][  ][Wr][  ][Wd][  ][  ][B ]
[Hd][  ][  ][  ][  ][Wd][  ][Wu][  ][  ][  ][  ][  ][  ][  ][  ]
[  ][B ][Hu][  ][  ][  ][  ][  ][Hr][  ][B ][  ][  ][  ][  ][  ]
