[  ][Ex][  ][  ][B ][B ][  ][  ][  ][  ][Hu][  ][Wl][  ][  ][  ]
[  ][  ][  ][  ][  ][  ][  ][Wu][  ][B ][Wr][D ][  ][Wd][  ][  ]
[  ][  ][  ][  ][  ][  ][Hu][  ][  ][Hd][B ][  ][B ][  ][  ][  ]
[  ][  ][  ][  ][  ][  ][  ][  ][  ][  ][  ][Wl][B ][B ][  ][  ]
[  ][  ][  ][  ][  ][  ][  ][  ][  ][  ][  ][B ][  ][B ][B ][  ]
[Hl][  ][  ][  ][  ][  ][  ][  ][  ][  ][Hu][  ][Hu][B ][  ][  ]
[  ][  ][  ][Hr][  ][  ][  ][  ][  ][  ][  ][Hu][  ][  ][  ][  ]
[  ][  ][  ][  ][  ][Wd][  ][  ][  ][  ][  ][  ][  ][  ][  ][  ]
[  ][Wd][  ][  ][  ][Hd][  ][  ][Wd][  ][  ][  ][  ][  ][  ][  ]
