[  ][Ex][  ][  ][  ][  ][  ][  ][  ][  ][  ][  ][Wd][B ][  ][  ]
[  ][  ][Hl][  ][  ][  ][B ][B ][Hu][  ][  ][D ][B ][  ][  ][Hl]
[  ][  ][  ][  ][  ][  ][  ][  ][  ][  ][  ][  ][  ][  ][  ][B ]
[  ][  ][  ][Wd][  ][  ][  ][  ][  ][  ][  ][  ][  ][  ][  ][  ]
[  ][  ][  ][  ][  ][  ][B ][Hd][  ][  ][B ][B ][  ][  ][  ][  ]
[Hl][  ][  ][  ][  ][  ][Wl][  ][  ][  ][B ][  ][  ][Wl][  ][  ]
[  ][  ][  ][Hl][B ][  ][  ][B ][  ][  ][  ][  ][  ][  ][  ][B ]
[  ][  ][  ][  ][  ][  ][Wu][  ][Hu][  ][  ][  ][  ][  ][  ][  ]
[  ][Wl][  ][  ][  ][  ][  ][  ][  ][  ][  ][Wd][  ][  ][Wl][Wu]
