[  ][Ex][Wd][  ][  ][  ][  ][  ][Wu][  ][  ][  ][Wd][B ][  ][  ]
[  ][  ][Hl][  ][Wr][  ][B ][B ][Hu][  ][  ][D ][B ][Wl][  ][Hl]
[  ][  ][  ][  ][  ][  ][Hu][  ][  ][  ][  ][  ][  ][  ][  ][Hd]
[Hr][Wu][  ][Wd][  ][  ][  ][  ][  ][Wl][  ][  ][  ][  ][  ][  ]
[  ][  ][  ][  ][  ][  ][  ][Hd][Wu][  ][  ][B ][  ][  ][  ][Wd]
[Hd][  ][  ][Wr][  ][Hl][  ][  ][  ][  ][B ][  ][  ][  ][B ][  ]
[  ][  ][  ][  ][  ][  ][  ][  ][Hl][  ][  ][Wd][Wd][  ][  ][Wu]
[  ][  ][Hd][  ][  ][Wr][Wu][  ][  ][  ][  ][  ][  ][  ][B ][  ]
[  ][  ][  ][  ][  ][B ][  ][Wd][  ][  ][B ][Wd][Wu][  ][Wl][  ]
