[  ][Ex][  ][  ][B ][  ][  ][  ][  ][  ][  ][  ][Wl][B ][Wd][Hu]
[  ][  ][B ][  ][  ][  ][  ][  ][  ][B ][Wd][D ][  ][Wd][  ][  ]
[  ][  ][  ][  ][  ][  ][  ][B ][  ][  ][  ][  ][  ][  ][Hr][  ]
[  ][  ][B ][  ][Wu][  ][  ][  ][  ][  ][  ][Wl][  ][B ][  ][  ]
[  ][Wd][  ][  ][  ][  ][B ][  ][  ][  ][  ][  ][B ][B ][Wu][  ]
[Hl][  ][Wu][  ][B ][Hu][  ][  ][  ][  ][  ][  ][Hu][Wu][  ][Hd]
[  ][  ][  ][  ][  ][Hl][  ][  ][  ][  ][Wr][B ][  ][  ][  ][  ]
[  ][  ][  ][  ][  ][Wd][  ][  ][  ][  ][  ][  ][  ][  ][  ][  ]
[  ][  ][B ][Wr][  ][Hd][  ][  ][Wd][  ][  ][  ][  ][  ][  ][Wd]
