[D ][  ][  ][  ][  ][  ][Hu][  ][  ][Hu][  ][B ][  ][  ][Wd][  ]
[Wd][  ][  ][  ][  ][  ][Hu][  ][  ][B ][  ][  ][  ][Hu][  ][  ]
[  ][  ][  ][  ][Wu][  ][  ][  ][  ][  ][  ][  ][Wr][B ][  ][  ]
[  ][  ][  ][  ][  ][Wl][B ][Wr][  ][Hr][  ][B ][  ][  ][  ][  ]
[  ][  ][  ][  ][Hr][  ][  ][Hd][  ][  ][  ][  ][Hr][  ][  ][B ]
[  ][  ][  ][  ][Hu][  ][  ][  ][  ][  ][  ][  ][  ][  ][  ][  ]
[  ][  ][  ][  ][  ][  ][  ][  ][  ][Hl][  ][  ][  ][  ][  ][  ]
[  ][B ][Hr][  ][  ][  ][  ][  ][  ][  ][  ][Hu][  ][B ][  ][  ]
[  ][  ][  ][B ][  ][  ][  ][Wu][  ][  ][  ][  ][  ][  ][  ][Ex]
