[D ][  ][B ][  ][  ][  ][  ][  ][  ][  ][  ][  ][  ][Hu][  ][  ]
[  ][  ][Hr][  ][  ][  ][  ][Hu][  ][  ][  ][  ][  ][  ][  ][  ]
[  ][  ][  ][  ][  ][  ][  ][  ][B ][  ][  ][  ][  ][  ][  ][  ]
[  ][  ][  ][  ][  ][  ][  ][  ][  ][  ][  ][  ][  ][  ][  ][  ]
[  ][  ][  ][  ][  ][  ][  ][  ][  ][  ][  ][  ][  ][  ][  ][  ]
[  ][  ][  ][  ][  ][B ][  ][  ][  ][  ][  ][  ][  ][  ][Wr][  ]
[  ][  ][  ][  ][  ][  ][  ][  ][  ][  ][Hd][  ][  ][  ][Hd][  ]
[  ][B ][  ][  ][B ][  ][  ][B ][  ][  ][  ][  ][  ][  ][  ][  ]
[  ][  ][  ][  ][  ][  ][  ][  ][  ][  ][  ][B ][  ][  ][  ][Ex]
