[D ][  ][Hr][  ][  ][  ][  ][  ][  ][B ][  ][B ][  ][Wr][  ][  ]
[Wd][  ][  ][  ][  ][  ][  ][  ][  ][B ][  ][  ][  ][B ][  ][  ]
[  ][Wl][  ][  ][  ][B ][  ][  ][  ][  ][  ][  ][  ][  ][B ][  ]
[  ][  ][  ][B ][  ][  ][  ][  ][  ][Hr][  ][  ][Wr][  ][  ][B ]
[  ][  ][Hd][  ][Hr][  ][  ][  ][  ][  ][  ][  ][B ][  ][  ][  ]
[  ][  ][  ][  ][  ][  ][  ][  ][  ][  ][  ][  ][  ][  ][  ][  ]
[  ][  ][  ][  ][Hl][  ][  ][  ][  ][  ][  ][  ][Wd][B ][  ][  ]
[  ][Wr][B ][  ][  ][  ][  ][  ][  ][  ][  ][Hu][  ][  ][  ][  ]
[  ][  ][B ][  ][  ][  ][  ][  ][  ][Hd][  ][  ][  ][  ][  ][Ex]
