[D ][  ][Hd][  ][  ][  ][  ][  ][  ][  ][  ][  ][Wd][  ][Wl][  ]
[  ][  ][B ][  ][  ][  ][Wu][  ][  ][B ][  ][  ][  ][  ][  ][  ]
[  ][Hd][Wr][  ][  ][  ][  ][  ][  ][  ][Wr][  ][  ][  ][  ][  ]
[B ][  ][  ][  ][  ][  ][  ][  ][  ][Wu][  ][  ][Hu][  ][  ][  ]
[  ][  ][  ][  ][  ][Wl][  ][  ][  ][  ][  ][  ][  ][  ][Hu][  ]
[  ][  ][  ][  ][B ][  ][  ][  ][Hl][  ][  ][B ][  ][  ][  ][  ]
[  ][Wr][  ][  ][  ][  ][  ][  ][  ][  ][  ][Wu][Wd][  ][  ][  ]
[  ][  ][  ][  ][  ][B ][  ][Wr][  ][  ][  ][  ][  ][B ][  ][Wl]
[  ][  ][Wd][  ][  ][  ][  ][  ][  ][  ][  ][  ][  ][  ][  ][Ex]
