[D ][  ][  ][  ][  ][Wd][  ][  ][  ][  ][  ][  ][  ][  ][  ][  ]
[  ][  ][  ][  ][  ][  ][  ][  ][  ][Wu][  ][  ][  ][  ][  ][  ]
[  ][  ][  ][  ][  ][B ][  ][B ][  ][B ][  ][  ][  ][  ][  ][  ]
[  ][  ][  ][  ][  ][Hu][  ][  ][Wd][  ][  ][  ][  ][B ][  ][  ]
[  ][  ][  ][  ][B ][  ][  ][  ][  ][Hd][  ][  ][  ][  ][  ][  ]
[  ][  ][  ][  ][  ][  ][Wl][  ][  ][  ][  ][  ][B ][B ][Hd][  ]
[Wu][  ][  ][  ][  ][  ][  ][  ][  ][  ][  ][  ][  ][  ][B ][  ]
[  ][  ][  ][  ][  ][  ][  ][  ][B ][  ][  ][Wd][  ][  ][  ][Hu]
[  ][  ][  ][  ][  ][  ][  ][  ][  ][  ][  ][  ][  ][  ][  ][Ex]
