[D ][  ][  ][  ][  ][  ][  ][  ][  ][  ][  ][  ][  ][  ][  ][  ]
[  ][  ][  ][  ][  ][  ][  ][  ][  ][B ][B ][Wu][  ][  ][  ][  ]
[Hd][  ][B ][  ][Hl][B ][  ][  ][  ][  ][B ][Hl][  ][  ][  ][  ]
[  ][B ][  ][  ][  ][  ][  ][  ][  ][  ][  ][  ][  ][  ][  ][  ]
[  ][Hr][  ][  ][B ][  ][  ][  ][  ][  ][  ][  ][B ][Wl][  ][  ]
[  ][  ][  ][  ][B ][  ][  ][  ][  ][  ][  ][B ][  ][  ][  ][  ]
[Wu][  ][  ][  ][  ][  ][Wr][  ][  ][  ][  ][  ][  ][  ][B ][  ]
[Wu][  ][Wl][  ][B ][  ][  ][  ][B ][  ][  ][  ][  ][  ][  ][  ]
[  ][  ][  ][  ][  ][  ][  ][  ][  ][  ][Wu][Hd][  ][Hd][  ][Ex]
