[D ][  ][  ][  ][  ][  ][Hl][  ][  ][  ][  ][  ][  ][  ][Wd][  ]
[  ][  ][Wu][  ][  ][  ][  ][  ][  ][  ][  ][  ][  ][  ][  ][  ]
[  ][  ][B ][  ][  ][B ][Hl][B ][B ][B ][  ][  ][  ][  ][Hr][B ]
[  ][B ][Hd][  ][  ][  ][  ][  ][  ][  ][  ][  ][  ][B ][  ][  ]
[  ][  ][  ][  ][B ][  ][  ][  ][  ][  ][  ][  ][  ][  ][  ][  ]
[  ][  ][B ][  ][B ][  ][Wl][  ][  ][  ][  ][  ][  ][  ][  ][  ]
[Wu][  ][  ][  ][  ][  ][  ][  ][  ][  ][  ][  ][  ][  ][B ][  ]
[Wu][  ][Wl][  ][B ][  ][  ][  ][B ][  ][  ][Wd][  ][  ][  ][  ]
[  ][  ][  ][  ][  ][  ][  ][  ][  ][  ][Wu][Hd][  ][Hd][  ][Ex]
