[D ][  ][  ][  ][  ][  ][  ][  ][  ][  ][  ][  ][  ][  ][  ][  ]
[  ][  ][  ][  ][  ][  ][  ][  ][  ][  ][  ][  ][  ][  ][  ][  ]
[  ][Wd][  ][  ][  ][  ][  ][  ][  ][  ][  ][  ][  ][  ][  ][Wd]
[  ][  ][  ][  ][  ][  ][  ][  ][  ][  ][  ][Hd][  ][  ][  ][  ]
[  ][  ][  ][B ][  ][  ][  ][  ][  ][  ][  ][  ][  ][  ][  ][  ]
[Wu][  ][  ][  ][  ][  ][  ][  ][  ][  ][  ][Wl][  ][  ][  ][  ]
[  ][  ][Wd][  ][  ][  ][  ][  ][  ][  ][  ][  ][  ][  ][B ][  ]
[  ][  ][  ][  ][  ][  ][  ][  ][Wu][  ][  ][  ][  ][  ][  ][  ]
[  ][  ][  ][  ][  ][  ][  ][  ][  ][  ][  ][  ][  ][  ][  ][Ex]
