[D ][  ][Hu][  ][  ][  ][Hu][  ][  ][Hu][  ][B ][  ][  ][  ][  ]
[Wd][  ][  ][  ][  ][  ][Wl][  ][  ][B ][  ][  ][  ][  ][  ][  ]
[  ][  ][  ][  ][B ][B ][  ][  ][  ][  ][  ][  ][  ][B ][  ][  ]
[  ][  ][  ][Hu][  ][B ][  ][  ][  ][Hr][  ][  ][  ][  ][  ][  ]
[  ][  ][  ][  ][  ][  ][  ][  ][  ][  ][  ][  ][Hr][  ][  ][  ]
[  ][  ][  ][  ][  ][  ][  ][  ][  ][  ][  ][  ][  ][  ][  ][  ]
[  ][  ][  ][  ][  ][  ][  ][  ][  ][Hl][  ][  ][  ][  ][  ][  ]
[  ][  ][B ][  ][  ][  ][  ][  ][  ][  ][  ][  ][  ][B ][  ][  ]
[  ][  ][B ][  ][  ][  ][  ][  ][  ][  ][  ][  ][  ][  ][  ][Ex]
