[D ][  ][B ][  ][  ][  ][  ][  ][  ][  ][  ][  ][  ][  ][  ][  ]
[  ][  ][  ][  ][  ][  ][  ][  ][  ][Wu][  ][Wu][  ][  ][  ][  ]
[  ][  ][  ][  ][  ][  ][  ][  ][Wl][  ][  ][  ][  ][  ][Wr][  ]
[  ][  ][  ][  ][  ][  ][  ][  ][  ][  ][  ][  ][  ][  ][  ][  ]
[  ][  ][  ][  ][  ][  ][  ][  ][Hl][  ][  ][  ][  ][  ][  ][  ]
[  ][  ][Hu][  ][  ][  ][  ][Hd][B ][  ][  ][  ][  ][  ][  ][  ]
[  ][  ][B ][  ][  ][  ][  ][  ][  ][  ][  ][  ][  ][  ][  ][  ]
[  ][  ][  ][  ][  ][  ][  ][  ][  ][  ][  ][  ][  ][  ][  ][  ]
[  ][  ][Wd][  ][  ][  ][  ][  ][  ][  ][  ][  ][  ][  ][  ][Ex]
