[D ][  ][  ][  ][Hl][  ][  ][  ][  ][  ][  ][  ][  ][  ][  ][  ]
[  ][  ][  ][  ][  ][  ][  ][  ][  ][B ][B ][  ][  ][Wu][  ][  ]
[  ][  ][  ][  ][  ][  ][  ][  ][  ][  ][  ][  ][  ][  ][  ][Wr]
[  ][  ][  ][  ][  ][  ][  ][  ][  ][  ][  ][  ][  ][  ][  ][Wu]
[  ][  ][  ][  ][  ][  ][  ][  ][  ][  ][  ][  ][  ][  ][  ][  ]
[  ][  ][  ][  ][  ][  ][  ][  ][  ][  ][  ][Hu][  ][  ][  ][Hd]
[  ][  ][  ][  ][Hd][  ][  ][B ][  ][  ][  ][  ][  ][  ][  ][  ]
[  ][B ][  ][  ][  ][B ][B ][  ][  ][  ][  ][  ][  ][  ][  ][Wd]
[  ][  ][  ][  ][  ][  ][  ][  ][  ][  ][  ][  ][  ][  ][  ][Ex]
