[D ][  ][  ][  ][  ][  ][  ][  ][  ][  ][  ][  ][  ][  ][Hr][  ]
[  ][  ][  ][  ][  ][  ][  ][  ][  ][  ][  ][  ][Hd][  ][  ][Wu]
[  ][  ][  ][  ][  ][B ][  ][  ][  ][  ][  ][  ][  ][  ][  ][  ]
[  ][  ][  ][  ][Wu][  ][  ][  ][  ][  ][  ][Hl][  ][  ][  ][  ]
[  ][  ][  ][  ][  ][  ][Hl][  ][  ][  ][  ][  ][  ][  ][  ][Hr]
[  ][  ][  ][  ][  ][  ][  ][  ][  ][  ][  ][  ][  ][  ][  ][  ]
[  ][  ][  ][  ][  ][  ][  ][  ][  ][  ][B ][  ][  ][  ][Wu][  ]
[  ][  ][  ][  ][  ][  ][  ][  ][  ][  ][  ][  ][  ][  ][  ][  ]
[  ][  ][  ][Wd][  ][  ][  ][  ][  ][  ][  ][  ][  ][  ][  ][Ex]
