[D ][  ][  ][  ][  ][  ][  ][  ][  ][  ][  ][  ][  ][  ][  ][  ]
[  ][B ][  ][  ][  ][  ][  ][  ][  ][  ][  ][  ][  ][  ][  ][  ]
[  ][  ][  ][  ][  ][  ][  ][  ][  ][  ][  ][  ][  ][  ][  ][Wd]
[  ][  ][  ][  ][  ][  ][  ][  ][  ][  ][  ][Hd][  ][  ][  ][  ]
[  ][Hu][  ][  ][  ][  ][  ][Hd][  ][  ][  ][  ][  ][  ][  ][  ]
[  ][  ][  ][  ][Hl][  ][  ][  ][  ][  ][  ][  ][  ][  ][  ][Wr]
[  ][  ][Wd][  ][  ][Wu][  ][  ][  ][  ][  ][  ][  ][  ][  ][  ]
[  ][  ][  ][  ][  ][  ][  ][  ][  ][  ][  ][  ][  ][  ][  ][  ]
[  ][  ][  ][B ][  ][  ][Hr][  ][  ][  ][  ][  ][  ][  ][  ][Ex]
