[D ][  ][  ][  ][  ][  ][  ][  ][  ][  ][  ][  ][  ][  ][  ][  ]
[Wd][  ][  ][  ][  ][  ][  ][  ][  ][  ][  ][  ][  ][  ][  ][  ]
[  ][  ][  ][  ][B ][  ][  ][  ][  ][  ][  ][  ][  ][B ][  ][  ]
[  ][  ][  ][  ][  ][  ][  ][  ][Hd][Hr][  ][  ][  ][  ][  ][  ]
[  ][  ][  ][  ][Hr][  ][B ][  ][  ][  ][  ][  ][Hr][  ][  ][  ]
[  ][  ][  ][  ][  ][  ][  ][  ][  ][  ][  ][B ][  ][  ][  ][  ]
[  ][  ][  ][  ][  ][  ][  ][  ][  ][  ][  ][  ][  ][  ][Hd][  ]
[  ][  ][  ][  ][B ][  ][  ][  ][  ][  ][  ][  ][  ][B ][  ][  ]
[  ][  ][Hd][  ][  ][  ][  ][  ][  ][  ][  ][  ][  ][  ][  ][Ex]
