[D ][  ][  ][  ][  ][B ][  ][B ][  ][  ][  ][  ][  ][  ][  ][  ]
[  ][  ][  ][  ][  ][  ][  ][  ][  ][  ][  ][  ][  ][  ][  ][  ]
[  ][  ][  ][  ][  ][Wd][Hu][  ][  ][  ][  ][Wr][  ][  ][  ][  ]
[  ][  ][  ][  ][  ][  ][  ][  ][Wu][  ][  ][  ][  ][  ][  ][  ]
[  ][  ][  ][  ][  ][  ][  ][  ][Hr][  ][  ][  ][Hr][  ][  ][  ]
[  ][  ][Hd][  ][  ][  ][  ][  ][  ][  ][  ][  ][  ][  ][  ][  ]
[Hu][  ][  ][  ][  ][  ][  ][  ][Wu][  ][  ][  ][  ][  ][  ][  ]
[  ][  ][  ][  ][  ][  ][  ][  ][  ][  ][B ][  ][  ][  ][  ][  ]
[  ][  ][  ][  ][  ][  ][  ][Wl][  ][  ][  ][  ][  ][  ][  ][Ex]
