[D ][  ][  ][  ][  ][  ][  ][Hr][  ][  ][  ][  ][  ][  ][  ][  ]
[  ][  ][B ][  ][  ][  ][  ][  ][  ][  ][  ][  ][  ][  ][  ][  ]
[Wd][  ][  ][  ][B ][  ][  ][  ][  ][  ][  ][  ][B ][  ][  ][  ]
[  ][  ][  ][  ][  ][Wd][  ][  ][  ][  ][  ][  ][  ][B ][Wu][  ]
[  ][  ][  ][  ][  ][  ][  ][Hr][  ][  ][Wd][  ][  ][  ][  ][  ]
[  ][  ][  ][  ][  ][  ][  ][  ][  ][  ][  ][  ][  ][  ][Wd][  ]
[  ][  ][  ][  ][  ][  ][  ][  ][  ][  ][  ][  ][  ][B ][  ][  ]
[  ][  ][  ][  ][  ][  ][  ][  ][  ][  ][  ][  ][  ][  ][  ][  ]
[  ][  ][  ][  ][  ][  ][B ][  ][  ][  ][Hr][  ][  ][  ][  ][Ex]
