[D ][  ][  ][  ][  ][  ][  ][  ][  ][  ][  ][  ][  ][  ][  ][  ]
[  ][  ][Wu][  ][  ][  ][  ][  ][  ][Wu][  ][  ][  ][  ][  ][  ]
[  ][  ][  ][  ][  ][B ][  ][B ][  ][B ][  ][  ][  ][  ][Hr][  ]
[  ][  ][  ][  ][  ][  ][  ][  ][B ][  ][  ][  ][  ][B ][  ][  ]
[  ][  ][  ][  ][B ][  ][  ][  ][  ][  ][  ][  ][  ][  ][  ][  ]
[  ][  ][  ][  ][  ][  ][Wl][B ][  ][  ][  ][  ][B ][B ][Hd][  ]
[Wu][  ][  ][  ][  ][  ][  ][  ][  ][  ][Wu][  ][  ][  ][B ][  ]
[  ][  ][  ][  ][  ][  ][B ][  ][B ][  ][  ][Wd][  ][  ][  ][Hu]
[  ][  ][  ][  ][  ][  ][  ][  ][Hu][  ][  ][  ][  ][  ][  ][Ex]
