[D ][  ][  ][  ][  ][  ][  ][  ][  ][  ][  ][  ][  ][  ][  ][  ]
[  ][  ][  ][  ][  ][  ][  ][  ][  ][  ][Wd][Wu][  ][  ][  ][  ]
[  ][  ][  ][  ][Hl][B ][  ][  ][B ][  ][  ][  ][  ][  ][  ][  ]
[Wu][B ][  ][  ][  ][  ][  ][  ][  ][  ][  ][  ][  ][  ][  ][  ]
[  ][Hr][  ][  ][  ][  ][  ][  ][  ][  ][Hl][  ][Hr][Hr][  ][  ]
[  ][  ][B ][  ][B ][Hd][  ][  ][  ][  ][  ][  ][  ][  ][  ][  ]
[Wu][  ][  ][  ][B ][  ][B ][  ][  ][  ][Wr][  ][  ][  ][  ][  ]
[  ][  ][Wl][  ][  ][  ][  ][  ][B ][  ][  ][  ][  ][  ][  ][  ]
[  ][  ][  ][  ][  ][  ][  ][  ][  ][  ][Wu][Hd][  ][Hd][  ][Ex]
