[D ][  ][  ][  ][  ][  ][  ][Hd][  ][  ][  ][  ][  ][  ][  ][  ]
[  ][  ][  ][  ][  ][  ][  ][  ][Wd][  ][  ][  ][  ][  ][  ][  ]
[  ][B ][  ][  ][  ][  ][  ][  ][  ][  ][  ][  ][  ][  ][  ][  ]
[  ][  ][Wu][B ][  ][  ][  ][  ][  ][  ][  ][B ][  ][  ][  ][  ]
[  ][  ][  ][  ][  ][  ][  ][Hl][  ][  ][  ][  ][  ][  ][  ][  ]
[  ][  ][  ][  ][  ][  ][  ][Wu][Hu][  ][  ][Wd][  ][  ][  ][  ]
[  ][  ][  ][  ][  ][  ][  ][  ][  ][  ][  ][  ][  ][  ][  ][  ]
[  ][  ][  ][  ][  ][  ][  ][  ][  ][  ][  ][  ][  ][  ][  ][  ]
[  ][  ][  ][  ][  ][  ][  ][  ][  ][B ][  ][  ][Wu][  ][  ][Ex]
