[D ][  ][  ][  ][  ][B ][Hu][  ][  ][  ][  ][B ][  ][Hr][  ][  ]
[Wd][  ][  ][  ][  ][  ][  ][  ][  ][B ][  ][  ][  ][Hu][  ][  ]
[  ][  ][  ][  ][  ][B ][Wd][  ][  ][  ][  ][  ][  ][  ][  ][  ]
[  ][  ][  ][B ][  ][  ][  ][  ][  ][Hr][  ][  ][Wr][  ][  ][  ]
[  ][  ][  ][  ][Hr][  ][  ][Wd][  ][  ][  ][  ][Hr][  ][  ][  ]
[  ][  ][  ][  ][  ][  ][  ][  ][  ][  ][  ][  ][  ][  ][  ][  ]
[  ][  ][  ][  ][  ][  ][  ][  ][  ][Hl][  ][  ][B ][B ][  ][  ]
[  ][  ][B ][  ][  ][  ][  ][  ][  ][  ][  ][Hu][  ][B ][  ][  ]
[  ][  ][B ][  ][  ][  ][  ][  ][  ][  ][  ][  ][  ][  ][  ][Ex]
