[D ][  ][B ][  ][B ][  ][  ][  ]
[  ][  ][Hu][  ][  ][  ][Wr][  ]
[Wd][B ][  ][Wl][Wr][Wd][B ][  ]
[  ][  ][  ][B ][Wu][  ][  ][  ]
[Wd][  ][B ][B ][B ][  ][B ][  ]
[  ][  ][  ][  ][  ][  ][Wu][Wr]
[  ][  ][Wu][  ][  ][Hd][  ][  ]
[  ][Wl][B ][  ][Wl][  ][B ][Ex]
