[D ][  ][  ][  ][  ][B ][  ][Wr]
[Wl][  ][B ][  ][B ][  ][Wd][B ]
[  ][  ][Hl][B ][  ][  ][  ][  ]
[  ][  ][  ][Hu][  ][  ][  ][Wu]
[  ][  ][B ][  ][Hr][  ][  ][  ]
[  ][  ][B ][  ][  ][  ][B ][  ]
[  ][  ][  ][B ][  ][  ][  ][B ]
[  ][  ][  ][Hu][Wd][  ][  ][Ex]
