[D ][  ][Hr][  ][Hu][  ][  ][  ]
[  ][  ][Wu][  ][  ][Hu][  ][  ]
[B ][  ][  ][Wl][Hr][  ][  ][  ]
[  ][B ][  ][  ][  ][Hd][  ][Wr]
[  ][  ][  ][  ][  ][  ][Wl][  ]
[  ][  ][  ][  ][  ][  ][  ][  ]
[Hl][Wr][  ][Wd][  ][  ][  ][  ]
[  ][  ][  ][  ][  ][  ][Wd][Ex]
