[D ][Hu][  ][B ][  ][B ][B ][  ]
[  ][Wu][B ][Hd][  ][  ][Wl][B ]
[  ][  ][B ][  ][  ][  ][  ][B ]
[  ][  ][  ][  ][B ][  ][  ][B ]
[Wd][  ][Wl][  ][  ][  ][  ][  ]
[  ][Hr][  ][Wl][  ][  ][Wu][B ]
[  ][  ][  ][  ][  ][  ][  ][  ]
[Wl][  ][  ][  ][  ][  ][  ][Ex]
