[D ][  ][Hr][  ][Hu][  ][  ][  ]
[B ][  ][Wu][  ][  ][  ][  ][  ]
[B ][  ][  ][  ][Hr][  ][  ][  ]
[B ][B ][  ][  ][Hr][Hd][  ][Wr]
[Hd][  ][  ][  ][  ][  ][  ][  ]
[  ][  ][  ][  ][B ][  ][B ][  ]
[  ][  ][Hu][Wd][  ][Wl][  ][  ]
[  ][  ][  ][  ][  ][  ][Wd][Ex]
