[D ][B ][  ][  ][  ][  ][B ][  ]
[  ][Wu][  ][  ][  ][  ][Wl][B ]
[  ][  ][  ][  ][  ][  ][  ][  ]
[B ][  ][  ][  ][B ][  ][  ][B ]
[  ][  ][Wl][  ][  ][  ][  ][B ]
[  ][Hr][Wl][  ][  ][  ][Wl][  ]
[  ][Wu][  ][  ][  ][B ][  ][  ]
[  ][  ][  ][  ][  ][  ][  ][Ex]
