[D ][  ][  ][  ][  ][  ][  ][B ]
[Hr][  ][  ][  ][  ][  ][  ][  ]
[  ][  ][  ][  ][B ][  ][B ][  ]
[B ][  ][  ][  ][  ][Hr][  ][  ]
[Hl][  ][  ][B ][  ][  ][  ][B ]
[Wd][Hr][  ][  ][  ][  ][  ][B ]
[  ][B ][  ][B ][B ][  ][  ][  ]
[B ][  ][  ][  ][  ][  ][  ][Ex]
