[D ][  ][Hr][  ][Hu][  ][  ][  ]
[  ][  ][Wu][  ][  ][  ][  ][  ]
[B ][  ][  ][Wl][Hr][  ][  ][  ]
[  ][B ][  ][  ][  ][Hd][  ][  ]
[  ][  ][  ][B ][  ][  ][  ][  ]
[  ][  ][  ][  ][  ][  ][Hr][  ]
[Hl][Wr][  ][B ][  ][  ][  ][  ]
[  ][  ][  ][  ][  ][  ][Wd][Ex]
