[D ][  ][B ][  ][  ][B ][  ][  ]
[  ][  ][Hd][  ][  ][  ][B ][  ]
[Wd][  ][  ][Wl][  ][Wu][  ][  ]
[  ][  ][  ][B ][Wu][  ][  ][  ]
[  ][  ][B ][  ][  ][  ][  ][Wr]
[  ][  ][  ][  ][  ][  ][  ][Wr]
[  ][Wd][  ][  ][Wu][Hd][  ][  ]
[  ][  ][  ][Hl][  ][  ][B ][Ex]
