[D ][  ][Hr][  ][  ][  ][  ][  ]
[Wu][Wu][  ][  ][  ][  ][  ][  ]
[B ][  ][Wd][B ][  ][  ][  ][  ]
[  ][  ][  ][  ][  ][Hd][  ][Wl]
[  ][  ][  ][  ][  ][  ][  ][Wr]
[  ][  ][  ][  ][B ][  ][  ][  ]
[  ][Hl][  ][Wd][  ][  ][  ][  ]
[Wd][  ][  ][  ][Hl][  ][Wd][Ex]
