[D ][  ][  ][  ][Hu][  ][  ][  ]
[  ][  ][  ][B ][  ][  ][  ][  ]
[  ][  ][  ][B ][  ][  ][  ][  ]
[  ][  ][  ][  ][  ][Hd][  ][Wr]
[  ][  ][  ][Hu][  ][  ][Wl][  ]
[  ][Wd][  ][  ][  ][B ][  ][  ]
[Hl][Wr][  ][  ][  ][B ][  ][  ]
[  ][  ][  ][  ][  ][  ][Wd][Ex]
