[D ][  ][Hr][  ][  ][  ][  ][B ]
[Hl][  ][  ][  ][  ][  ][Hl][  ]
[  ][  ][  ][B ][  ][  ][B ][  ]
[B ][B ][  ][  ][  ][  ][  ][  ]
[B ][B ][  ][  ][Hl][  ][  ][  ]
[Wd][  ][  ][  ][  ][  ][  ][  ]
[  ][Hl][  ][  ][B ][  ][  ][  ]
[B ][  ][  ][  ][  ][  ][  ][Ex]
