[D ][  ][  ][  ][Hu][  ][  ][  ]
[B ][  ][Wu][  ][  ][Hu][  ][  ]
[  ][  ][  ][Wl][Hr][  ][  ][  ]
[Hl][B ][  ][  ][  ][Wr][  ][Wr]
[Hd][  ][Wr][  ][  ][  ][  ][  ]
[  ][  ][  ][  ][B ][  ][B ][  ]
[Hl][  ][Hu][Wd][  ][  ][  ][  ]
[Wl][  ][  ][  ][  ][  ][Wd][Ex]
