[D ][  ][B ][  ][B ][  ][  ][  ]
[  ][  ][Hu][  ][  ][  ][B ][  ]
[Wd][B ][  ][Wl][Wr][Wd][B ][  ]
[Hu][  ][  ][B ][Wu][  ][  ][  ]
[  ][  ][B ][  ][  ][  ][B ][  ]
[  ][  ][  ][Hu][  ][  ][Wu][Wr]
[Wu][B ][B ][  ][  ][  ][  ][  ]
[  ][Wl][  ][  ][  ][  ][B ][Ex]
