[D ][  ][  ][Wr][  ][B ][  ][Hu]
[  ][B ][B ][  ][  ][  ][  ][B ]
[  ][  ][B ][B ][  ][  ][  ][  ]
[  ][  ][  ][Hu][  ][Hu][  ][B ]
[  ][  ][  ][  ][  ][  ][  ][  ]
[  ][  ][Wl][  ][  ][  ][B ][  ]
[  ][  ][  ][  ][B ][  ][  ][Wd]
[  ][  ][  ][Hu][Wd][  ][  ][Ex]
