[D ][  ][Wl][Wr][  ][  ][B ][  ]
[  ][Wu][  ][  ][  ][  ][  ][  ]
[  ][  ][  ][  ][  ][  ][  ][  ]
[  ][  ][  ][  ][  ][  ][Wl][B ]
[Hd][  ][Hr][  ][  ][  ][  ][B ]
[  ][Hr][Wl][  ][Wl][  ][Hl][B ]
[  ][Wu][  ][  ][  ][  ][  ][  ]
[Hu][  ][  ][  ][Wd][  ][  ][Ex]
