[D ][  ][  ][  ][  ][  ][  ][  ]
[  ][  ][  ][Hd][Hu][  ][  ][Hl]
[  ][  ][  ][B ][  ][Hd][  ][  ]
[  ][  ][  ][  ][  ][  ][  ][  ]
[  ][  ][  ][  ][  ][  ][  ][B ]
[  ][  ][B ][  ][Hl][  ][B ][Wr]
[  ][  ][Wr][  ][  ][  ][  ][  ]
[  ][B ][  ][  ][  ][  ][  ][Ex]
