[D ][B ][  ][  ][  ][  ][  ][  ]
[  ][Wu][  ][  ][  ][  ][  ][Hl]
[  ][Hu][  ][  ][  ][Wr][  ][  ]
[  ][  ][  ][  ][  ][  ][  ][  ]
[  ][  ][Hr][  ][  ][  ][  ][B ]
[  ][  ][Wu][  ][  ][  ][  ][  ]
[  ][  ][  ][  ][  ][  ][  ][  ]
[  ][  ][  ][  ][  ][  ][  ][Ex]
