[D ][  ][Hr][  ][Hu][  ][  ][  ]
[  ][  ][Wu][  ][Wd][Hu][  ][  ]
[B ][  ][  ][Wl][Hr][  ][  ][  ]
[  ][B ][  ][  ][  ][  ][  ][Wr]
[  ][  ][  ][  ][  ][  ][  ][  ]
[  ][  ][  ][  ][  ][  ][Hr][  ]
[Hl][Wr][  ][Wd][  ][  ][  ][  ]
[  ][  ][  ][  ][  ][Wr][Wd][Ex]
