[D ][  ][  ][  ][Hu][  ][  ][  ]
[  ][  ][Wu][  ][  ][  ][  ][  ]
[B ][  ][  ][Wl][Hr][  ][  ][  ]
[  ][B ][  ][  ][  ][Hd][B ][  ]
[  ][  ][  ][  ][  ][Wl][  ][  ]
[  ][  ][  ][  ][Hu][Wd][  ][  ]
[Hl][Wr][B ][Wd][  ][  ][  ][  ]
[  ][  ][  ][  ][  ][  ][Wd][Ex]
