[D ][  ][  ][  ][  ][  ][  ][B ]
[Hl][  ][  ][  ][  ][Hr][Hl][  ]
[  ][  ][  ][  ][Hu][  ][B ][  ]
[B ][  ][  ][B ][  ][Hl][  ][  ]
[B ][B ][Wd][B ][  ][  ][  ][B ]
[Wd][  ][  ][Wr][  ][  ][  ][Wr]
[  ][Hl][  ][B ][B ][  ][  ][  ]
[B ][  ][  ][  ][  ][  ][  ][Ex]
