[D ][  ][  ][  ][  ][B ][  ][Wr]
[Wl][  ][B ][B ][B ][  ][Wd][B ]
[  ][  ][  ][B ][B ][Wl][  ][  ]
[  ][Hl][  ][  ][  ][  ][  ][Wu]
[  ][  ][B ][  ][Hr][  ][Wr][  ]
[  ][  ][  ][  ][  ][  ][Wl][  ]
[  ][  ][  ][B ][  ][  ][Wu][  ]
[  ][  ][B ][Hu][Hl][  ][  ][Ex]
