[D ][  ][  ][  ][  ][  ][Wu][  ]
[  ][  ][  ][B ][  ][B ][  ][Wr]
[  ][  ][  ][  ][  ][  ][  ][  ]
[B ][  ][  ][  ][  ][Hr][  ][  ]
[  ][  ][  ][Wr][  ][  ][  ][B ]
[  ][Hr][  ][  ][  ][  ][  ][B ]
[  ][  ][  ][  ][Wl][  ][  ][  ]
[  ][  ][  ][  ][Wd][  ][  ][Ex]
