[D ][  ][  ][  ][  ][  ][  ][  ]
[  ][  ][  ][  ][  ][  ][  ][Hl]
[  ][  ][  ][  ][  ][B ][Hd][  ]
[B ][  ][  ][  ][  ][  ][  ][  ]
[  ][Hd][  ][  ][  ][  ][  ][  ]
[  ][Wu][  ][  ][  ][  ][B ][Wr]
[  ][  ][  ][  ][  ][  ][  ][  ]
[Hl][  ][  ][  ][B ][  ][  ][Ex]
