[D ][  ][B ][  ][B ][  ][  ][  ]
[Wl][  ][Hu][  ][  ][  ][B ][  ]
[Wd][B ][  ][Wl][  ][  ][B ][  ]
[  ][  ][  ][B ][Wu][  ][  ][  ]
[  ][  ][B ][  ][  ][  ][B ][  ]
[  ][  ][  ][  ][  ][  ][  ][Wr]
[  ][  ][  ][  ][  ][B ][  ][  ]
[  ][  ][  ][Wd][  ][  ][B ][Ex]
