[D ][B ][  ][  ][  ][Wd][B ][  ]
[  ][Wu][  ][B ][  ][  ][Wl][  ]
[Hl][  ][  ][  ][Wd][  ][  ][  ]
[  ][  ][  ][B ][  ][B ][Wr][B ]
[B ][  ][Wl][  ][  ][  ][  ][B ]
[  ][Hl][Wl][  ][  ][B ][  ][  ]
[  ][  ][  ][  ][  ][  ][  ][  ]
[  ][  ][  ][  ][  ][  ][  ][Ex]
