[D ][  ][B ][  ][Wl][B ][Wl][  ]
[  ][  ][Wl][  ][  ][  ][  ][  ]
[  ][  ][  ][Wl][Wl][Wu][  ][  ]
[Wu][  ][  ][B ][Wu][  ][  ][  ]
[  ][  ][B ][  ][  ][  ][  ][Wr]
[  ][  ][  ][  ][  ][  ][  ][Wr]
[  ][Wd][  ][  ][Wu][  ][  ][  ]
[  ][  ][  ][Hl][  ][  ][B ][Ex]
