[D ][  ][  ][  ][  ][Hu][  ][  ]
[Wd][  ][Hl][  ][  ][  ][  ][  ]
[  ][Wr][  ][  ][  ][  ][  ][  ]
[  ][Wd][  ][  ][Wu][  ][  ][  ]
[  ][  ][  ][  ][  ][  ][  ][  ]
[Wd][  ][  ][  ][  ][B ][Wd][Wr]
[Hr][  ][  ][B ][  ][Hd][  ][  ]
[  ][  ][  ][  ][Hu][  ][Hr][Ex]
