[D ][  ][B ][  ][  ][  ][  ][  ]
[B ][  ][  ][  ][  ][Hd][  ][Wu]
[  ][  ][  ][  ][Hr][  ][  ][  ]
[B ][B ][  ][B ][  ][  ][Wd][  ]
[  ][  ][  ][  ][  ][  ][  ][  ]
[  ][  ][  ][  ][B ][Wu][  ][  ]
[B ][  ][  ][Wd][  ][  ][  ][  ]
[  ][  ][B ][  ][Wu][  ][  ][Ex]
