[D ][  ][B ][  ][Wl][B ][Wl][  ]
[  ][  ][Wl][  ][  ][  ][  ][  ]
[  ][  ][  ][Wl][Wl][Hd][  ][  ]
[B ][  ][  ][B ][Wu][  ][  ][  ]
[  ][  ][B ][  ][  ][  ][  ][Wr]
[  ][  ][  ][  ][  ][  ][  ][Wr]
[  ][Wd][  ][  ][  ][  ][  ][  ]
[  ][  ][  ][  ][  ][  ][B ][Ex]
