[D ][  ][  ][B ][  ][B ][B ][  ]
[  ][Wu][B ][Hd][  ][  ][Hd][B ]
[  ][  ][  ][  ][  ][  ][  ][B ]
[  ][  ][  ][  ][B ][  ][  ][B ]
[Wd][  ][Wl][  ][  ][  ][  ][  ]
[  ][Hr][  ][Wl][  ][  ][Wu][B ]
[  ][  ][  ][  ][  ][  ][  ][  ]
[Wl][  ][  ][  ][  ][  ][B ][Ex]
