[D ][  ][B ][  ][Hu][  ][Wd][  ]
[B ][  ][Wu][  ][  ][Wd][  ][Wu]
[B ][B ][  ][Wl][Hr][  ][  ][  ]
[B ][B ][  ][  ][  ][  ][  ][Wr]
[Hd][  ][  ][  ][B ][  ][  ][  ]
[  ][  ][  ][  ][B ][  ][B ][  ]
[  ][  ][Hu][Wd][  ][  ][  ][  ]
[  ][  ][  ][  ][  ][  ][Wd][Ex]
