[D ][  ][Hr][  ][  ][  ][  ][  ]
[Hl][  ][  ][  ][  ][  ][Hl][  ]
[  ][  ][  ][B ][  ][  ][B ][  ]
[  ][B ][  ][  ][  ][  ][Hd][  ]
[Hr][  ][  ][  ][  ][  ][  ][  ]
[Wd][  ][  ][  ][  ][  ][B ][  ]
[  ][  ][  ][  ][B ][Wd][  ][  ]
[B ][  ][  ][  ][  ][  ][  ][Ex]
