[D ][  ][  ][  ][  ][  ][  ][B ]
[Hl][  ][  ][B ][  ][  ][  ][  ]
[  ][  ][  ][  ][Hr][  ][B ][  ]
[B ][Wd][  ][  ][B ][  ][  ][  ]
[B ][  ][  ][B ][  ][  ][  ][Wu]
[Wd][Wd][  ][  ][  ][  ][Wu][B ]
[  ][B ][  ][B ][B ][B ][  ][  ]
[B ][  ][  ][  ][Hd][  ][  ][Ex]
