[D ][  ][  ][Hu][  ][Hl][  ][  ]
[  ][  ][  ][  ][  ][Hr][Hr][Wl]
[  ][  ][  ][  ][  ][  ][  ][Hr]
[  ][  ][  ][  ][B ][  ][  ][Hu]
[  ][  ][Wu][  ][  ][  ][  ][  ]
[  ][  ][  ][  ][  ][  ][  ][  ]
[  ][  ][  ][  ][Wr][  ][  ][  ]
[  ][  ][  ][  ][  ][  ][  ][Ex]
