[D ][B ][Wl][Wr][  ][  ][B ][Wl]
[  ][Wu][  ][  ][  ][  ][Wl][  ]
[  ][  ][  ][  ][  ][  ][  ][  ]
[B ][  ][  ][  ][  ][Hr][  ][B ]
[  ][  ][Wl][  ][  ][  ][  ][B ]
[  ][Hr][Wl][  ][  ][  ][  ][  ]
[  ][Wu][  ][  ][  ][  ][  ][  ]
[  ][  ][  ][  ][Wd][  ][  ][Ex]
