[D ][  ][  ][  ][  ][Wr][Wu][  ]
[  ][  ][  ][  ][B ][Wl][  ][Wd]
[  ][Wr][  ][  ][B ][  ][  ][  ]
[  ][Wd][  ][  ][Wu][  ][  ][  ]
[  ][  ][  ][  ][  ][  ][  ][  ]
[Wr][  ][  ][B ][  ][B ][Wd][Wr]
[B ][  ][Hr][B ][  ][Hd][  ][  ]
[  ][  ][Wd][  ][Hu][  ][Hr][Ex]
