[D ][  ][  ][Wr][  ][  ][B ][Wl]
[  ][Wu][  ][  ][  ][B ][  ][Wr]
[  ][  ][  ][  ][  ][  ][  ][Wu]
[B ][  ][  ][  ][  ][  ][  ][B ]
[  ][  ][Hr][  ][  ][  ][  ][B ]
[  ][Hr][Wl][  ][  ][  ][Hl][B ]
[B ][Wu][  ][  ][Wl][  ][  ][  ]
[  ][Wd][  ][  ][Wd][  ][  ][Ex]
