[D ][  ][  ][  ][  ][Hu][  ][  ]
[  ][  ][  ][  ][  ][Wr][  ][  ]
[  ][  ][  ][  ][  ][  ][  ][  ]
[  ][Wd][  ][B ][  ][  ][  ][  ]
[  ][  ][  ][  ][  ][  ][  ][  ]
[  ][  ][  ][  ][  ][  ][Wd][Wr]
[  ][  ][Wr][  ][  ][Hd][  ][  ]
[  ][  ][  ][Wl][Hu][  ][  ][Ex]
