[D ][B ][  ][  ][  ][  ][B ][Wl]
[  ][Wu][  ][  ][  ][  ][  ][Hl]
[  ][  ][  ][  ][  ][Wr][  ][  ]
[B ][  ][  ][  ][  ][  ][  ][  ]
[  ][  ][Hr][  ][  ][  ][  ][B ]
[  ][  ][  ][  ][  ][  ][  ][  ]
[  ][Wu][  ][  ][  ][  ][  ][  ]
[  ][  ][  ][  ][Wd][  ][  ][Ex]
