[D ][B ][  ][Hu][  ][Hl][B ][  ]
[  ][  ][  ][B ][  ][Hr][  ][Wl]
[  ][  ][  ][  ][Wl][Hd][  ][Hr]
[  ][  ][Hr][  ][B ][  ][  ][Hu]
[  ][  ][Wu][  ][  ][B ][Wu][  ]
[  ][  ][B ][  ][  ][  ][B ][  ]
[  ][  ][  ][  ][Wr][  ][  ][  ]
[  ][  ][  ][  ][  ][  ][  ][Ex]
