[D ][  ][  ][  ][  ][Hu][  ][  ]
[Wd][  ][Hl][  ][Wr][B ][  ][  ]
[  ][Wr][  ][  ][  ][  ][  ][  ]
[  ][Wd][  ][  ][  ][  ][  ][  ]
[  ][  ][  ][  ][  ][  ][  ][  ]
[  ][  ][  ][  ][  ][B ][Wd][Wr]
[Hr][  ][Hu][  ][  ][B ][  ][  ]
[  ][  ][  ][Wl][Hu][  ][  ][Ex]
