[D ][  ][  ][  ][  ][  ][  ][B ]
[Hl][  ][  ][  ][  ][Hr][Hl][  ]
[B ][  ][  ][  ][Hu][  ][B ][  ]
[B ][  ][  ][  ][  ][Hl][  ][  ]
[B ][B ][Wd][B ][  ][  ][  ][B ]
[B ][  ][  ][Wr][  ][  ][  ][  ]
[  ][Hl][  ][B ][  ][  ][  ][  ]
[B ][  ][  ][  ][  ][  ][  ][Ex]
