[D ][  ][  ][  ][  ][  ][Wu][  ]
[  ][Wu][  ][B ][  ][B ][  ][  ]
[  ][  ][  ][  ][  ][  ][  ][Wr]
[B ][  ][  ][  ][  ][  ][B ][  ]
[  ][  ][Hr][  ][  ][  ][  ][B ]
[  ][Hr][  ][  ][  ][  ][  ][  ]
[  ][  ][  ][  ][Wl][  ][  ][  ]
[  ][B ][  ][  ][Wd][  ][  ][Ex]
