[D ][  ][  ][  ][  ][Hu][  ][  ]
[Wd][  ][Hl][  ][  ][B ][  ][  ]
[  ][Wr][  ][  ][  ][  ][  ][  ]
[  ][Wd][  ][  ][Wu][  ][  ][  ]
[  ][  ][  ][  ][  ][  ][  ][  ]
[Wd][  ][  ][  ][  ][B ][Wd][Wr]
[Hr][  ][  ][  ][  ][Hd][  ][  ]
[  ][  ][  ][Wl][Hu][  ][  ][Ex]
