[D ][  ][Wl][  ][  ][Wl][B ][  ]
[  ][Wu][B ][  ][  ][B ][  ][  ]
[  ][  ][  ][  ][  ][  ][  ][  ]
[B ][  ][  ][  ][  ][Hr][  ][B ]
[  ][  ][  ][Wl][  ][  ][  ][B ]
[  ][Hr][  ][  ][  ][  ][Hl][B ]
[  ][  ][  ][  ][Wl][  ][  ][  ]
[Hu][Wd][  ][  ][Wd][  ][  ][Ex]
