[D ][  ][  ][Wu][  ][  ][  ][  ]
[Hl][  ][  ][  ][  ][  ][Hl][  ]
[  ][  ][  ][Wu][  ][  ][Wr][  ]
[  ][B ][  ][  ][  ][  ][  ][Wd]
[Hr][  ][  ][  ][  ][Wl][  ][  ]
[Wd][Hl][Wd][  ][  ][  ][B ][  ]
[  ][  ][B ][  ][B ][Hu][  ][  ]
[B ][  ][  ][  ][  ][  ][Hu][Ex]
