[D ][  ][  ][  ][  ][  ][  ][  ]
[  ][Wu][  ][  ][  ][  ][  ][  ]
[B ][  ][Wd][B ][  ][  ][  ][  ]
[  ][  ][  ][  ][  ][Hd][  ][Wl]
[  ][  ][Wl][  ][  ][  ][  ][Wr]
[  ][  ][  ][  ][B ][  ][  ][  ]
[  ][B ][  ][Wd][  ][  ][  ][  ]
[Wd][  ][  ][  ][Hl][  ][Wd][Ex]
