[D ][  ][B ][  ][  ][Hr][Wu][  ]
[  ][Wu][  ][B ][  ][B ][  ][  ]
[  ][  ][  ][  ][  ][  ][  ][B ]
[B ][  ][  ][  ][  ][  ][B ][  ]
[Hu][  ][Hr][Hd][  ][  ][  ][B ]
[  ][B ][  ][Hu][  ][Wr][  ][  ]
[  ][  ][  ][Wr][Wl][  ][  ][  ]
[  ][B ][  ][  ][Wr][  ][  ][Ex]
