[D ][  ][Wl][Wr][  ][  ][B ][Wl]
[  ][Wu][  ][  ][  ][B ][  ][Wr]
[  ][  ][  ][  ][  ][  ][  ][  ]
[B ][  ][  ][  ][  ][  ][Wl][B ]
[  ][  ][Hr][  ][  ][  ][  ][B ]
[  ][Hr][Wl][  ][  ][  ][Hl][B ]
[  ][Wu][  ][  ][Wl][  ][  ][  ]
[  ][  ][  ][  ][Wd][  ][  ][Ex]
