[D ][  ][  ][  ][  ][  ][  ][  ]
[  ][  ][  ][Hd][  ][  ][  ][Hl]
[  ][  ][  ][B ][  ][B ][  ][  ]
[B ][  ][  ][  ][  ][  ][  ][  ]
[  ][Hd][  ][  ][  ][  ][  ][B ]
[  ][  ][  ][  ][Hl][  ][B ][Wr]
[  ][  ][  ][  ][  ][  ][  ][  ]
[Hl][  ][  ][  ][B ][  ][  ][Ex]
