[D ][B ][Wl][Wr][  ][  ][B ][Hl]
[  ][Wu][  ][  ][  ][  ][  ][Wr]
[  ][  ][  ][  ][  ][  ][  ][  ]
[  ][  ][  ][  ][  ][Hr][  ][B ]
[  ][  ][  ][  ][  ][  ][  ][Hr]
[  ][  ][Wl][  ][  ][  ][  ][B ]
[  ][Wu][  ][  ][  ][  ][  ][  ]
[  ][  ][  ][  ][Wd][  ][B ][Ex]
