[D ][  ][Hr][  ][Hu][  ][  ][  ]
[B ][  ][Wu][  ][  ][  ][  ][  ]
[B ][  ][  ][Wl][Hr][  ][  ][  ]
[B ][B ][  ][  ][  ][Hd][  ][Wr]
[  ][  ][  ][  ][  ][  ][  ][  ]
[  ][  ][  ][  ][B ][  ][B ][  ]
[Hl][  ][Hu][Wd][  ][  ][  ][  ]
[  ][  ][  ][  ][  ][  ][Wd][Ex]
