[D ][  ][B ][  ][  ][Hr][Wu][  ]
[  ][Wu][  ][  ][  ][  ][  ][  ]
[  ][Wr][  ][  ][  ][B ][  ][Wu]
[B ][  ][  ][  ][  ][  ][B ][  ]
[Hu][  ][Hr][Hd][  ][  ][  ][  ]
[  ][B ][  ][  ][  ][Wr][  ][  ]
[  ][  ][  ][Wr][Wl][Hl][  ][  ]
[  ][  ][  ][  ][Wr][  ][  ][Ex]
