[D ][  ][Hu][  ][  ][  ][  ][  ]
[B ][  ][  ][  ][  ][Hd][  ][Wu]
[  ][  ][  ][  ][Wd][B ][Hd][  ]
[B ][B ][  ][B ][  ][  ][Wd][  ]
[Hr][  ][  ][  ][  ][  ][  ][  ]
[  ][  ][Hd][  ][B ][  ][  ][  ]
[Wl][B ][  ][Wd][  ][  ][  ][  ]
[  ][  ][B ][  ][Wu][  ][  ][Ex]
