[D ][  ][  ][Wr][  ][  ][  ][Hu]
[  ][Hl][Hd][  ][  ][  ][  ][  ]
[  ][  ][  ][Hd][  ][  ][  ][  ]
[  ][  ][  ][Wu][  ][Hu][  ][B ]
[  ][  ][  ][  ][  ][  ][  ][  ]
[  ][  ][Wl][  ][  ][  ][  ][  ]
[  ][  ][  ][  ][  ][  ][  ][Wd]
[  ][  ][  ][  ][  ][  ][  ][Ex]
