[D ][  ][  ][  ][  ][  ][  ][  ]
[  ][  ][  ][  ][Hu][  ][  ][Hl]
[  ][  ][  ][B ][  ][Hd][  ][  ]
[  ][  ][  ][  ][  ][  ][Wd][  ]
[  ][Hd][  ][  ][Wd][  ][  ][B ]
[  ][  ][B ][  ][Hl][  ][B ][Wr]
[  ][  ][  ][  ][  ][  ][  ][  ]
[  ][  ][  ][  ][  ][  ][  ][Ex]
