[D ][  ][B ][B ][  ][  ][  ][  ]
[  ][B ][Hd][  ][  ][  ][B ][  ]
[  ][  ][  ][Wl][  ][Wu][  ][  ]
[  ][  ][  ][  ][Wu][B ][  ][  ]
[  ][  ][  ][  ][  ][  ][  ][B ]
[  ][  ][  ][  ][  ][  ][Wd][Wr]
[  ][Wd][  ][  ][Wr][Hd][  ][  ]
[  ][  ][  ][Hl][  ][  ][Wu][Ex]
