[D ][  ][  ][Wd][  ][  ][  ][B ]
[Hl][  ][  ][  ][  ][  ][Hl][  ]
[  ][  ][  ][  ][Hr][  ][B ][  ]
[B ][  ][  ][  ][B ][  ][  ][  ]
[B ][  ][  ][B ][  ][  ][Hl][Wu]
[Wd][Wd][  ][  ][  ][  ][  ][B ]
[  ][B ][  ][B ][B ][  ][  ][  ]
[B ][Wd][  ][  ][  ][  ][  ][Ex]
