[D ][  ][B ][B ][  ][B ][  ][  ]
[  ][Wl][Hd][  ][  ][  ][B ][  ]
[  ][  ][  ][Wl][  ][Wu][  ][  ]
[  ][  ][  ][B ][Wu][B ][  ][  ]
[  ][  ][B ][  ][  ][  ][  ][B ]
[  ][  ][  ][  ][  ][  ][  ][Wr]
[  ][Wd][  ][  ][Wr][Hd][  ][  ]
[  ][  ][  ][Hl][  ][  ][Wu][Ex]
