[D ][  ][  ][  ][  ][B ][  ][  ]
[  ][B ][  ][  ][  ][  ][B ][  ]
[  ][  ][  ][  ][  ][Hd][B ][  ]
[Hr][  ][  ][Wr][  ][  ][  ][  ]
[  ][  ][  ][  ][  ][  ][  ][  ]
[  ][  ][  ][  ][Hl][  ][  ][Wr]
[  ][  ][Wr][  ][  ][Hd][  ][  ]
[  ][  ][  ][Hr][Hu][  ][  ][Ex]
