[D ][  ][Hr][  ][  ][  ][  ][  ]
[Wu][  ][  ][  ][  ][  ][  ][  ]
[  ][  ][  ][B ][  ][  ][  ][  ]
[  ][B ][  ][  ][  ][  ][  ][  ]
[  ][  ][  ][  ][  ][  ][  ][Wr]
[  ][  ][  ][  ][  ][  ][B ][  ]
[B ][Hl][  ][  ][  ][  ][  ][Hu]
[  ][  ][  ][  ][Hl][  ][  ][Ex]
