[D ][  ][  ][  ][  ][Hu][  ][  ]
[  ][  ][Wu][  ][  ][  ][  ][  ]
[B ][Hd][  ][Wl][Hr][  ][  ][  ]
[  ][B ][  ][  ][  ][Hd][  ][  ]
[  ][  ][B ][  ][  ][  ][  ][  ]
[  ][  ][  ][  ][Hu][  ][  ][  ]
[  ][  ][  ][Wd][  ][  ][  ][  ]
[  ][  ][  ][  ][  ][  ][Hr][Ex]
