[D ][  ][  ][  ][  ][  ][  ][B ]
[Hl][  ][  ][  ][  ][  ][Hl][  ]
[  ][  ][  ][  ][Hu][  ][B ][  ]
[B ][B ][  ][  ][  ][Hl][  ][  ]
[B ][Hl][Wd][  ][Hl][  ][  ][  ]
[  ][B ][  ][  ][  ][  ][  ][Wr]
[  ][Hl][  ][  ][B ][  ][  ][  ]
[  ][  ][  ][  ][  ][  ][  ][Ex]
