[D ][B ][  ][  ][  ][  ][B ][Wl]
[  ][Wu][  ][  ][  ][  ][Wl][B ]
[  ][  ][  ][  ][  ][  ][  ][  ]
[B ][  ][  ][  ][  ][  ][  ][B ]
[  ][  ][Wl][  ][  ][  ][  ][B ]
[  ][Hr][Wl][  ][  ][  ][  ][  ]
[  ][Wu][Hr][  ][  ][  ][  ][  ]
[  ][  ][  ][  ][Wd][  ][  ][Ex]
