[D ][  ][B ][  ][  ][  ][  ][  ]
[  ][B ][Hd][  ][  ][  ][B ][  ]
[  ][  ][  ][Wl][  ][  ][  ][  ]
[  ][Wd][  ][B ][  ][  ][  ][  ]
[  ][  ][  ][  ][  ][  ][  ][  ]
[  ][  ][  ][  ][  ][  ][Wd][Wr]
[  ][  ][  ][  ][  ][Hd][  ][  ]
[  ][  ][  ][Wu][Hu][  ][  ][Ex]
