[D ][  ][Wl][Wr][  ][  ][  ][Wl]
[  ][Wu][B ][  ][  ][B ][  ][Wr]
[  ][  ][  ][  ][  ][  ][  ][Wd]
[B ][  ][  ][  ][  ][Hu][  ][B ]
[  ][  ][Hr][  ][  ][  ][  ][  ]
[  ][  ][Wl][  ][  ][  ][  ][B ]
[  ][  ][  ][  ][Wl][  ][  ][Wd]
[  ][Wd][  ][  ][Wd][  ][  ][Ex]
