[D ][  ][  ][  ][  ][  ][  ][Wr][  ][Hu][  ][  ][  ][  ][B ][  ]
[  ][  ][  ][  ][  ][  ][B ][  ][  ][  ][  ][  ][  ][  ][Hu][  ]
[  ][  ][Wu][  ][Hr][  ][  ][Hl][  ][  ][  ][  ][B ][B ][B ][  ]
[  ][  ][  ][Hr][  ][  ][  ][  ][  ][  ][Wr][  ][  ][  ][  ][  ]
[  ][  ][  ][  ][  ][  ][  ][  ][  ][  ][  ][  ][Hd][  ][  ][  ]
[  ][  ][  ][  ][  ][  ][  ][  ][B ][Hd][  ][  ][  ][  ][  ][  ]
[  ][B ][  ][  ][  ][  ][  ][B ][Wl][  ][B ][  ][  ][  ][Wl][  ]
[B ][  ][  ][  ][  ][  ][  ][  ][  ][  ][  ][  ][  ][  ][B ][Wl]
[  ][  ][  ][B ][Hd][B ][  ][Hl][  ][  ][B ][  ][  ][  ][  ][Ex]
