[D ][  ][  ][  ][  ][  ][  ][  ][  ][  ][  ][Wd][  ][Wl][  ][Wl]
[  ][  ][Hd][  ][  ][  ][Hd][  ][  ][  ][  ][Wd][  ][  ][  ][  ]
[  ][  ][  ][  ][Hr][  ][  ][  ][  ][B ][  ][  ][  ][  ][  ][  ]
[Hl][  ][  ][  ][B ][  ][Wd][  ][  ][  ][Wr][Hu][  ][  ][  ][  ]
[  ][  ][  ][  ][Hl][  ][  ][  ][  ][  ][B ][  ][B ][  ][  ][  ]
[  ][  ][  ][  ][  ][  ][  ][  ][B ][  ][  ][  ][  ][  ][  ][  ]
[  ][  ][  ][  ][  ][  ][  ][B ][Hu][  ][B ][  ][  ][  ][  ][  ]
[  ][  ][  ][  ][  ][  ][  ][B ][B ][  ][  ][  ][  ][Wu][Wu][  ]
[  ][  ][Hd][B ][Hd][  ][  ][Hd][  ][  ][  ][  ][  ][  ][Wd][Ex]
