[D ][  ][  ][  ][  ][  ][  ][  ][  ][  ][  ][  ][  ][  ][  ][Wl]
[  ][  ][Hd][  ][  ][  ][  ][  ][  ][  ][  ][Wd][  ][  ][  ][B ]
[  ][  ][  ][  ][Hr][  ][  ][  ][  ][B ][B ][  ][  ][  ][  ][  ]
[  ][  ][  ][  ][  ][  ][Wd][  ][  ][  ][  ][Hu][  ][  ][  ][  ]
[Hl][  ][  ][  ][  ][  ][B ][  ][  ][Hr][  ][  ][B ][  ][  ][Wu]
[  ][  ][  ][  ][  ][  ][  ][  ][  ][  ][B ][  ][  ][B ][  ][  ]
[  ][  ][  ][  ][  ][  ][  ][B ][Hu][  ][B ][  ][  ][  ][Hu][  ]
[Wu][  ][  ][  ][  ][  ][  ][B ][  ][  ][  ][  ][  ][  ][  ][  ]
[  ][Hl][Hd][B ][Hd][  ][  ][Hd][  ][  ][  ][  ][  ][  ][  ][Ex]
