[D ][  ][  ][Wd][B ][  ][Hd][Hl][  ][  ][  ][  ][  ][B ][Hl][Wl]
[  ][  ][  ][  ][  ][B ][  ][  ][B ][  ][  ][Wd][  ][  ][  ][B ]
[  ][  ][  ][  ][  ][  ][B ][Hl][B ][B ][B ][  ][  ][  ][  ][  ]
[B ][  ][  ][  ][  ][  ][  ][  ][  ][  ][  ][  ][  ][  ][B ][Hr]
[  ][Hl][  ][Wl][B ][  ][  ][  ][  ][  ][  ][  ][  ][  ][  ][Wu]
[  ][Wu][  ][  ][B ][  ][  ][  ][  ][  ][B ][  ][  ][  ][  ][  ]
[  ][  ][  ][B ][Wr][  ][  ][B ][  ][  ][  ][  ][  ][Wu][  ][  ]
[  ][Wr][  ][Wl][  ][  ][  ][Hu][  ][Hd][  ][  ][Hd][  ][  ][B ]
[  ][  ][Hl][  ][  ][  ][Wl][Hd][  ][  ][  ][  ][  ][Wr][Hl][Ex]
