[D ][  ][  ][  ][  ][  ][  ][  ][  ][  ][  ][  ][B ][  ][  ][Wl]
[  ][  ][Hd][  ][  ][  ][  ][  ][  ][  ][  ][Wd][  ][  ][  ][  ]
[  ][  ][Wr][  ][Hr][  ][  ][  ][  ][B ][  ][  ][  ][  ][  ][  ]
[Hl][Wu][  ][  ][B ][  ][Wd][  ][  ][  ][Wr][  ][  ][  ][Wd][  ]
[  ][  ][  ][  ][Hl][  ][  ][  ][  ][Hr][B ][  ][B ][  ][  ][Hl]
[  ][  ][  ][  ][  ][  ][  ][  ][  ][  ][B ][  ][  ][  ][  ][  ]
[  ][Wu][  ][  ][  ][  ][  ][  ][Hu][  ][B ][  ][  ][  ][  ][  ]
[  ][Wr][  ][  ][Wu][  ][  ][B ][B ][  ][  ][  ][  ][Wu][  ][  ]
[  ][Hl][Hd][B ][Hd][  ][  ][Hd][Hr][  ][  ][  ][  ][  ][Wd][Ex]
