[D ][  ][  ][  ][  ][  ][  ][  ][  ][  ][  ][  ][B ][  ][B ][  ]
[  ][  ][Hr][  ][  ][  ][B ][  ][  ][  ][B ][  ][Hd][  ][  ][B ]
[  ][  ][  ][  ][Hr][Hr][  ][  ][  ][  ][  ][Hl][  ][  ][  ][  ]
[  ][  ][  ][  ][  ][  ][  ][  ][  ][  ][Hu][  ][B ][  ][  ][  ]
[  ][  ][  ][  ][  ][  ][  ][  ][Wl][  ][Wr][  ][Hd][  ][  ][  ]
[  ][  ][  ][  ][  ][  ][  ][B ][  ][  ][  ][  ][Wu][  ][  ][  ]
[  ][  ][  ][  ][  ][  ][B ][  ][  ][  ][B ][  ][  ][  ][  ][  ]
[  ][  ][  ][  ][  ][  ][Wu][  ][  ][  ][  ][  ][  ][Wr][B ][Wl]
[  ][  ][  ][Wr][  ][Wd][  ][  ][  ][  ][  ][B ][  ][  ][  ][Ex]
