[D ][  ][  ][  ][  ][  ][  ][  ][  ][  ][  ][  ][B ][  ][  ][Wl]
[  ][  ][  ][  ][  ][  ][  ][  ][  ][  ][  ][Wd][  ][  ][  ][  ]
[  ][  ][  ][  ][Hr][  ][  ][  ][  ][  ][  ][  ][  ][  ][  ][  ]
[  ][  ][  ][  ][  ][  ][Wd][  ][  ][  ][Wr][Hu][  ][  ][  ][  ]
[  ][  ][  ][  ][  ][  ][  ][  ][  ][  ][  ][  ][  ][  ][  ][  ]
[  ][  ][  ][  ][  ][  ][  ][  ][B ][  ][B ][  ][  ][Hr][  ][  ]
[  ][Wu][  ][  ][  ][  ][  ][B ][Hu][  ][B ][  ][  ][  ][  ][  ]
[  ][  ][B ][  ][  ][  ][  ][  ][  ][  ][  ][  ][  ][Wu][  ][  ]
[  ][  ][  ][B ][Hd][  ][  ][Hd][  ][  ][  ][  ][  ][  ][  ][Ex]
