[D ][B ][  ][  ][  ][  ][B ][B ][  ][  ][  ][B ][  ][  ][  ][Hr]
[  ][  ][  ][  ][  ][  ][Wu][Hl][Wl][  ][  ][Wd][  ][Wr][  ][  ]
[  ][  ][  ][  ][B ][  ][B ][  ][  ][B ][  ][  ][  ][  ][  ][  ]
[  ][  ][Wl][  ][  ][Wl][Hl][  ][Wd][  ][  ][Hu][  ][  ][  ][  ]
[  ][  ][  ][  ][  ][  ][B ][  ][  ][  ][B ][  ][Wu][  ][  ][  ]
[  ][  ][  ][  ][  ][  ][  ][B ][  ][  ][B ][  ][  ][  ][  ][  ]
[  ][  ][  ][  ][  ][  ][  ][  ][  ][  ][B ][  ][  ][Hr][  ][  ]
[  ][Wr][  ][  ][Wl][  ][  ][B ][  ][  ][  ][  ][  ][  ][  ][  ]
[  ][  ][Hd][B ][Wu][  ][  ][  ][  ][  ][  ][  ][  ][  ][  ][Ex]
