[D ][  ][  ][  ][  ][  ][  ][Hr][  ][  ][  ][  ][  ][  ][  ][Wl]
[  ][  ][Hd][  ][  ][  ][  ][  ][  ][  ][  ][Wd][  ][  ][  ][B ]
[  ][  ][  ][  ][  ][  ][  ][  ][  ][B ][  ][  ][  ][  ][  ][  ]
[  ][  ][Wd][  ][  ][  ][Wd][  ][  ][  ][  ][Hu][  ][  ][  ][  ]
[Wr][  ][  ][  ][Hl][  ][B ][  ][  ][Hr][  ][  ][B ][Wd][  ][Wu]
[  ][  ][  ][  ][  ][  ][  ][  ][B ][  ][B ][  ][  ][B ][  ][  ]
[  ][  ][  ][  ][  ][  ][  ][B ][Hu][  ][Wr][Hu][  ][  ][Hu][  ]
[  ][  ][  ][  ][  ][  ][  ][B ][  ][  ][  ][  ][  ][  ][  ][  ]
[  ][  ][Hd][B ][  ][  ][  ][Hd][  ][  ][  ][  ][  ][  ][Wd][Ex]
