[D ][  ][  ][  ][  ][  ][  ][  ][  ][  ][  ][B ][  ][  ][  ][  ]
[  ][  ][Hd][  ][  ][  ][  ][  ][  ][  ][  ][  ][  ][  ][  ][B ]
[  ][  ][  ][  ][Hr][  ][  ][  ][  ][B ][B ][  ][  ][  ][  ][  ]
[  ][  ][  ][  ][  ][  ][Wd][  ][  ][  ][  ][Hu][  ][  ][  ][  ]
[Hl][  ][  ][  ][  ][  ][B ][  ][  ][  ][  ][  ][B ][  ][B ][Wu]
[  ][  ][  ][  ][  ][  ][  ][  ][  ][  ][B ][  ][  ][B ][  ][  ]
[  ][B ][  ][  ][  ][  ][  ][B ][Hr][  ][B ][  ][  ][  ][  ][  ]
[Wu][  ][  ][  ][  ][  ][  ][B ][Wu][  ][  ][  ][  ][  ][  ][  ]
[  ][Hl][Hd][B ][Hd][  ][  ][Hd][  ][  ][  ][  ][  ][  ][  ][Ex]
