[D ][  ][  ][  ][B ][  ][Wd][  ][  ][  ][  ][  ][  ][  ][  ][  ]
[  ][  ][B ][Wr][  ][  ][  ][  ][Hd][  ][  ][Hu][  ][  ][  ][  ]
[  ][  ][Hl][  ][  ][B ][  ][  ][  ][  ][  ][  ][  ][  ][Wr][Hu]
[  ][  ][  ][  ][  ][  ][  ][  ][Hr][  ][Hd][  ][B ][  ][  ][  ]
[  ][  ][  ][  ][  ][Wu][  ][Hd][B ][  ][  ][  ][  ][  ][  ][B ]
[  ][  ][  ][  ][  ][  ][  ][  ][  ][  ][Wr][  ][  ][  ][  ][  ]
[  ][  ][  ][  ][  ][  ][  ][  ][  ][  ][  ][  ][  ][Hr][Wr][  ]
[  ][  ][  ][  ][  ][  ][  ][  ][  ][  ][  ][  ][  ][  ][  ][  ]
[  ][B ][  ][  ][  ][  ][  ][  ][  ][  ][  ][  ][  ][  ][  ][Ex]
