[D ][B ][  ][Hl][  ][  ][  ][  ][  ][  ][Hd][  ][  ][  ][  ][Wl]
[  ][  ][  ][  ][  ][  ][  ][  ][  ][  ][  ][Wd][  ][  ][  ][B ]
[  ][  ][  ][  ][Hr][  ][  ][  ][  ][B ][B ][  ][  ][  ][  ][  ]
[  ][  ][  ][  ][  ][  ][  ][  ][  ][  ][  ][B ][  ][  ][  ][  ]
[  ][  ][  ][  ][  ][  ][  ][  ][  ][Hr][B ][  ][B ][  ][  ][Wu]
[  ][  ][  ][  ][  ][  ][  ][  ][  ][  ][B ][  ][  ][  ][  ][  ]
[  ][  ][  ][  ][  ][  ][  ][  ][  ][  ][B ][  ][  ][  ][  ][  ]
[Wu][  ][  ][  ][  ][  ][  ][B ][  ][  ][  ][  ][  ][  ][  ][  ]
[  ][  ][Hd][  ][Hd][  ][  ][  ][  ][  ][  ][  ][  ][  ][  ][Ex]
