[D ][B ][  ][  ][  ][  ][B ][  ][  ][  ][  ][  ][  ][  ][  ][Hr]
[  ][  ][  ][  ][  ][  ][Wu][Hl][Wl][  ][  ][  ][  ][Wr][  ][  ]
[  ][  ][  ][  ][B ][  ][B ][  ][  ][  ][  ][  ][  ][  ][  ][  ]
[  ][  ][Wl][  ][  ][Wl][Hl][  ][Wd][  ][  ][Hu][  ][  ][  ][  ]
[  ][  ][  ][  ][  ][  ][B ][  ][Wd][  ][B ][  ][Wu][  ][  ][  ]
[  ][  ][  ][  ][  ][  ][  ][B ][  ][  ][B ][  ][  ][  ][  ][  ]
[  ][  ][  ][  ][  ][  ][  ][  ][Wl][  ][B ][  ][  ][Hr][  ][  ]
[  ][Wr][  ][  ][Wl][  ][  ][B ][  ][  ][  ][  ][  ][  ][  ][  ]
[  ][  ][Hd][B ][Wu][  ][  ][  ][  ][  ][  ][  ][  ][  ][  ][Ex]
