[D ][  ][  ][  ][  ][  ][  ][  ][Wl][  ][  ][  ][  ][  ][  ][Wl]
[  ][  ][Hd][  ][  ][  ][  ][  ][  ][  ][  ][Wd][  ][  ][  ][B ]
[  ][  ][  ][  ][  ][  ][  ][  ][  ][B ][  ][  ][  ][  ][  ][  ]
[  ][  ][Wd][  ][  ][  ][Wd][  ][  ][  ][Wr][  ][  ][  ][  ][  ]
[Wl][  ][  ][  ][Hl][  ][B ][  ][  ][Hr][  ][  ][B ][Wd][  ][Wu]
[  ][  ][  ][  ][  ][  ][  ][  ][B ][  ][  ][  ][  ][B ][  ][  ]
[  ][  ][  ][  ][  ][  ][  ][B ][Hu][  ][B ][Hu][  ][  ][Hu][  ]
[  ][  ][  ][  ][  ][  ][  ][B ][  ][  ][  ][  ][  ][  ][  ][  ]
[  ][  ][Hd][B ][Hd][  ][  ][Hd][  ][  ][  ][  ][  ][  ][  ][Ex]
