[D ][  ][  ][  ][  ][  ][  ][  ][  ][  ][  ][Wd][  ][  ][  ][Wl]
[  ][  ][  ][  ][  ][  ][Hd][  ][  ][  ][  ][  ][  ][  ][  ][  ]
[  ][  ][Wr][  ][Hr][  ][  ][  ][  ][  ][  ][  ][  ][  ][  ][Wr]
[Hl][  ][  ][  ][  ][  ][Wd][  ][  ][  ][Wr][  ][  ][  ][  ][  ]
[  ][  ][  ][  ][Hl][  ][  ][  ][  ][Hr][B ][  ][  ][  ][  ][Wu]
[  ][B ][  ][  ][  ][  ][  ][Wl][B ][  ][  ][  ][  ][B ][  ][  ]
[  ][Wu][  ][  ][  ][  ][  ][B ][Hu][  ][B ][  ][  ][  ][  ][  ]
[  ][  ][B ][  ][  ][  ][  ][B ][B ][  ][  ][  ][  ][Wu][  ][  ]
[  ][  ][Hd][B ][Hd][  ][  ][Hd][  ][B ][  ][  ][  ][  ][Wd][Ex]
