[D ][B ][  ][  ][  ][  ][B ][B ][  ][  ][  ][B ][  ][  ][  ][Hr]
[  ][  ][  ][  ][  ][  ][Wu][  ][Wl][  ][  ][Wd][  ][Wr][  ][  ]
[  ][  ][  ][  ][B ][  ][B ][  ][  ][B ][  ][  ][  ][  ][  ][  ]
[  ][  ][Wl][  ][  ][Wl][Hl][  ][Wd][  ][  ][Hu][  ][  ][  ][  ]
[  ][  ][Hl][  ][  ][  ][B ][  ][  ][  ][B ][  ][Wu][  ][  ][  ]
[  ][  ][  ][  ][  ][  ][  ][B ][  ][  ][B ][  ][  ][  ][  ][  ]
[  ][  ][  ][  ][  ][  ][  ][  ][  ][  ][B ][  ][  ][Hr][  ][B ]
[  ][Wr][  ][  ][Wl][  ][  ][  ][  ][  ][  ][  ][  ][  ][  ][  ]
[  ][  ][  ][  ][Wu][  ][  ][  ][  ][  ][  ][Wd][  ][  ][  ][Ex]
