[D ][  ][  ][  ][  ][  ][  ][  ][  ][  ][  ][  ][B ][  ][  ][Wl]
[  ][  ][Hd][  ][  ][  ][  ][  ][  ][  ][  ][Wd][  ][  ][  ][  ]
[  ][  ][Wr][  ][Hr][  ][  ][  ][  ][B ][  ][  ][  ][  ][  ][  ]
[Hl][Wu][  ][  ][B ][  ][Wd][  ][  ][  ][Wr][  ][  ][  ][  ][  ]
[  ][  ][  ][  ][Hl][  ][  ][  ][  ][Hr][B ][  ][B ][  ][  ][  ]
[  ][  ][  ][  ][  ][  ][  ][  ][B ][  ][B ][  ][  ][B ][  ][  ]
[  ][Wu][  ][  ][  ][  ][  ][B ][Hu][  ][B ][  ][  ][  ][  ][  ]
[  ][Wr][  ][  ][Wu][  ][  ][B ][B ][  ][  ][  ][  ][Wu][  ][  ]
[  ][Hl][Hd][B ][Hd][  ][  ][Hd][Hr][  ][  ][  ][  ][  ][Wd][Ex]
