[D ][  ][  ][  ][  ][  ][  ][  ][  ][  ][  ][  ][B ][  ][  ][Wl]
[  ][  ][  ][  ][  ][  ][  ][  ][  ][  ][  ][Wd][  ][  ][  ][  ]
[  ][  ][  ][  ][Hr][  ][  ][  ][  ][  ][  ][  ][  ][  ][B ][  ]
[  ][  ][  ][  ][  ][  ][Wd][  ][  ][  ][Wr][  ][  ][  ][  ][  ]
[  ][  ][  ][  ][  ][  ][  ][  ][  ][  ][  ][  ][  ][  ][  ][  ]
[  ][  ][  ][  ][  ][  ][  ][  ][B ][  ][  ][  ][  ][Hr][  ][  ]
[  ][Wu][  ][  ][  ][  ][  ][B ][  ][  ][B ][  ][  ][  ][  ][  ]
[Wu][  ][  ][  ][  ][B ][  ][  ][  ][  ][  ][  ][  ][  ][  ][  ]
[  ][  ][  ][B ][Hd][  ][  ][Hd][  ][  ][  ][  ][  ][  ][  ][Ex]
