[D ][  ][  ][  ][  ][  ][  ][  ][  ][  ][  ][Wd][  ][  ][  ][Wl]
[  ][  ][Hd][  ][  ][  ][  ][  ][  ][  ][  ][Wd][  ][  ][  ][  ]
[  ][  ][  ][  ][Hr][  ][  ][  ][  ][B ][  ][  ][  ][  ][  ][  ]
[Hl][  ][  ][  ][  ][  ][Wd][  ][  ][  ][Wr][  ][  ][  ][  ][  ]
[  ][  ][  ][  ][Hl][  ][  ][  ][  ][Hr][B ][  ][B ][Wl][  ][Wu]
[  ][  ][  ][  ][  ][  ][  ][  ][  ][  ][B ][  ][  ][B ][  ][Wr]
[  ][  ][  ][  ][  ][  ][  ][B ][Hu][  ][  ][  ][  ][  ][Hu][  ]
[  ][Wr][  ][  ][  ][  ][  ][B ][B ][  ][  ][  ][  ][Wu][  ][  ]
[  ][Hl][Hd][B ][  ][  ][  ][  ][  ][  ][  ][  ][  ][  ][Wd][Ex]
