[D ][  ][  ][  ][  ][  ][  ][Wr][  ][  ][  ][  ][B ][  ][B ][  ]
[  ][  ][Hu][  ][  ][  ][  ][  ][  ][  ][  ][Wd][  ][  ][  ][  ]
[  ][  ][  ][  ][  ][  ][  ][Hl][  ][  ][  ][  ][  ][  ][B ][  ]
[B ][  ][  ][  ][  ][  ][  ][  ][  ][  ][Wr][  ][  ][  ][  ][  ]
[  ][  ][  ][  ][  ][  ][  ][  ][  ][  ][  ][  ][Hd][  ][  ][  ]
[  ][  ][  ][  ][  ][  ][  ][  ][B ][  ][  ][  ][  ][Hr][  ][  ]
[  ][Wr][  ][  ][  ][  ][  ][B ][Hr][  ][B ][  ][  ][  ][Wl][  ]
[Wu][  ][  ][  ][  ][  ][  ][  ][  ][  ][  ][  ][  ][  ][  ][  ]
[  ][  ][  ][B ][Hd][B ][  ][  ][  ][  ][B ][  ][  ][  ][  ][Ex]
