[D ][  ][  ][  ][  ][  ][  ][  ][  ][  ][  ][  ][  ][Wd][  ][  ]
[  ][  ][Wr][  ][  ][  ][  ][  ][  ][B ][  ][  ][  ][B ][  ][  ]
[Wu][  ][  ][  ][  ][  ][  ][B ][  ][Hu][  ][  ][  ][B ][  ][  ]
[  ][Wd][  ][  ][  ][  ][  ][Hl][  ][  ][  ][  ][  ][B ][Wl][  ]
[  ][  ][  ][  ][  ][  ][  ][  ][  ][Hr][  ][  ][B ][  ][  ][  ]
[  ][  ][  ][B ][  ][  ][  ][  ][  ][  ][  ][  ][  ][  ][  ][  ]
[  ][  ][  ][  ][  ][  ][Wd][  ][  ][  ][  ][Wu][  ][  ][  ][  ]
[Wr][  ][  ][  ][  ][  ][  ][  ][  ][  ][  ][  ][  ][  ][  ][  ]
[Wd][  ][  ][  ][  ][  ][  ][  ][  ][  ][  ][  ][  ][  ][  ][Ex]
