[D ][  ][  ][  ][  ][B ][  ][  ][  ][  ][  ][  ][  ][  ][  ][  ]
[  ][  ][Hd][  ][  ][  ][  ][  ][  ][  ][  ][Wd][  ][  ][  ][  ]
[  ][  ][  ][  ][Hr][  ][  ][  ][  ][B ][  ][  ][  ][Hu][  ][  ]
[  ][  ][  ][  ][  ][  ][Wd][  ][  ][  ][Wr][Hu][  ][  ][  ][  ]
[Hl][  ][  ][  ][Hl][  ][B ][  ][  ][Hr][  ][  ][B ][  ][  ][Wu]
[  ][  ][  ][  ][  ][  ][  ][  ][  ][  ][  ][  ][  ][  ][  ][  ]
[  ][  ][  ][  ][  ][  ][  ][B ][Hu][  ][B ][  ][  ][  ][Hu][  ]
[  ][  ][  ][  ][  ][  ][  ][B ][  ][  ][  ][  ][  ][Wu][  ][  ]
[  ][Hl][Hd][B ][  ][Wd][  ][Hd][  ][  ][  ][  ][  ][  ][Wd][Ex]
