[D ][  ][  ][  ][  ][  ][  ][Wr][  ][  ][  ][  ][B ][  ][B ][  ]
[B ][  ][  ][  ][  ][  ][B ][  ][  ][  ][  ][  ][  ][  ][  ][  ]
[  ][  ][  ][  ][  ][  ][  ][Hl][  ][  ][  ][  ][B ][B ][Hl][  ]
[  ][  ][  ][  ][B ][  ][  ][  ][  ][  ][  ][  ][  ][  ][  ][  ]
[  ][  ][Hl][  ][  ][  ][  ][  ][  ][  ][  ][  ][Hd][  ][  ][  ]
[  ][  ][  ][  ][  ][  ][  ][  ][  ][Hd][  ][  ][  ][Hr][  ][  ]
[  ][  ][  ][  ][  ][  ][  ][B ][B ][  ][Wd][  ][  ][  ][  ][  ]
[B ][  ][  ][  ][  ][  ][  ][  ][  ][  ][  ][  ][  ][  ][B ][Wl]
[  ][  ][  ][B ][Hd][B ][  ][  ][  ][  ][B ][  ][  ][  ][  ][Ex]
