[  ][Hu][  ][B ][  ][  ][  ][  ][  ][  ][  ][  ][  ][Wd][  ][  ]
[  ][  ][  ][  ][  ][  ][  ][  ][  ][  ][  ][  ][  ][  ][  ][  ]
[  ][  ][  ][  ][  ][  ][  ][  ][  ][  ][  ][  ][  ][D ][  ][Hu]
[  ][  ][  ][  ][  ][  ][  ][B ][  ][  ][Wu][Hr][  ][  ][  ][  ]
[  ][  ][  ][  ][  ][Wu][Wr][  ][  ][Hl][  ][Wl][  ][  ][  ][Hr]
[  ][B ][  ][  ][  ][B ][  ][  ][  ][  ][  ][  ][  ][  ][  ][  ]
[  ][  ][  ][  ][  ][  ][  ][  ][Wu][Ex][  ][  ][B ][  ][Hd][Wd]
[  ][  ][  ][  ][Wl][  ][B ][Wr][Wu][  ][  ][  ][  ][  ][Wr][  ]
[  ][Wu][  ][  ][Wu][Hr][  ][  ][  ][  ][  ][  ][  ][  ][Wu][  ]
