[  ][  ][  ][Hu][  ][  ][  ][  ][  ][  ][  ][  ][  ][  ][  ][  ]
[  ][  ][  ][B ][  ][  ][  ][  ][  ][  ][  ][B ][  ][Hl][  ][  ]
[  ][  ][B ][  ][Wr][  ][B ][  ][  ][B ][  ][  ][  ][B ][Ex][  ]
[  ][Wr][  ][  ][  ][B ][  ][  ][  ][D ][Wd][  ][  ][  ][Hr][Hl]
[  ][  ][  ][  ][  ][B ][  ][  ][  ][  ][  ][  ][Hl][  ][  ][  ]
[Hl][B ][  ][  ][  ][  ][  ][  ][Wd][  ][B ][  ][  ][  ][  ][  ]
[  ][  ][  ][  ][B ][  ][  ][  ][  ][  ][B ][  ][  ][  ][  ][Wd]
[  ][Wu][  ][  ][B ][  ][  ][Hr][  ][Wu][Hl][  ][  ][B ][Hl][B ]
[Hl][  ][  ][  ][B ][  ][  ][Wl][  ][  ][  ][  ][  ][Wl][B ][  ]
