[  ][  ][  ][B ][Wl][Wr][  ][  ][  ][  ][  ][Wr][B ][  ][  ][  ]
[B ][  ][Wu][  ][  ][B ][  ][  ][Hd][  ][  ][  ][  ][Hu][  ][  ]
[Wl][  ][  ][  ][  ][  ][B ][  ][  ][  ][  ][  ][B ][D ][  ][Hd]
[  ][  ][  ][Hd][  ][  ][  ][B ][  ][  ][  ][  ][  ][  ][  ][  ]
[Hl][  ][  ][Hr][  ][  ][  ][  ][  ][  ][Wu][Wu][  ][  ][  ][Hr]
[  ][  ][B ][  ][  ][  ][Wu][B ][  ][  ][  ][Wr][  ][  ][Wl][  ]
[  ][  ][  ][  ][Hd][  ][  ][B ][  ][Ex][  ][  ][  ][B ][  ][  ]
[  ][  ][Wl][Wr][  ][  ][  ][B ][  ][Hd][  ][  ][  ][  ][B ][  ]
[  ][  ][Wu][  ][  ][  ][  ][Hl][  ][  ][  ][  ][  ][  ][  ][  ]
