[  ][Hu][  ][  ][  ][Hu][  ][  ][  ][  ][B ][  ][Hd][Wd][  ][Hl]
[B ][  ][Wd][  ][  ][  ][Wu][  ][  ][  ][  ][  ][  ][  ][  ][  ]
[  ][Wu][Hr][  ][B ][  ][  ][  ][Hl][  ][B ][  ][  ][D ][  ][Hu]
[Wl][  ][  ][  ][  ][B ][  ][B ][Hl][  ][  ][  ][  ][  ][  ][  ]
[Wr][B ][  ][  ][  ][Wu][  ][  ][  ][Hl][Hr][Wl][  ][  ][  ][  ]
[  ][B ][  ][  ][  ][  ][  ][  ][  ][  ][  ][  ][  ][  ][  ][  ]
[B ][Wd][  ][  ][Wu][  ][B ][Hd][Wu][Ex][  ][  ][B ][  ][  ][Wd]
[  ][Hu][  ][  ][  ][  ][B ][B ][  ][  ][  ][  ][Hd][  ][Wr][  ]
[  ][Wu][  ][  ][Wu][Hr][  ][  ][  ][  ][  ][  ][Hl][  ][Wl][  ]
