[  ][Hu][  ][  ][  ][Hu][  ][  ][  ][  ][  ][  ][Wl][Wd][  ][  ]
[  ][  ][Wd][  ][  ][Wd][  ][  ][  ][  ][  ][Hd][  ][  ][  ][  ]
[  ][  ][  ][  ][Wr][  ][Hl][  ][  ][  ][  ][  ][  ][D ][Wr][Hu]
[  ][  ][Wu][  ][  ][  ][  ][  ][  ][  ][Wu][Hr][  ][Hd][  ][  ]
[  ][Hd][  ][  ][  ][Wu][  ][  ][  ][Hl][Hr][Wl][  ][  ][  ][Hr]
[  ][B ][  ][  ][  ][B ][  ][  ][  ][  ][  ][  ][  ][  ][B ][Hd]
[  ][  ][  ][  ][  ][  ][  ][  ][Wu][Ex][  ][  ][B ][Wl][Hd][  ]
[  ][  ][  ][  ][  ][  ][B ][Wr][Wu][  ][  ][  ][  ][  ][Wr][Wl]
[  ][Wu][  ][Hd][Wu][  ][  ][Hd][  ][  ][  ][  ][  ][  ][Wu][  ]
