[B ][  ][  ][B ][  ][  ][  ][  ][Wu][  ][  ][  ][  ][  ][  ][  ]
[B ][B ][  ][  ][  ][Hu][  ][  ][  ][  ][  ][  ][  ][  ][  ][  ]
[  ][Wu][  ][  ][  ][B ][  ][  ][  ][  ][Wd][  ][  ][D ][Wl][Hu]
[  ][  ][  ][B ][  ][  ][  ][B ][  ][  ][  ][  ][B ][  ][  ][  ]
[  ][  ][B ][  ][  ][  ][  ][  ][  ][Hl][  ][Hu][  ][  ][  ][Hr]
[  ][B ][  ][  ][  ][  ][  ][B ][  ][  ][  ][  ][  ][Wu][  ][  ]
[  ][  ][  ][  ][  ][  ][B ][B ][  ][Ex][  ][  ][Wl][Wl][  ][  ]
[Hl][  ][  ][  ][B ][  ][  ][Wd][Wl][  ][  ][  ][  ][  ][Hu][  ]
[  ][Wl][  ][Hu][Wu][  ][  ][  ][  ][  ][  ][  ][  ][  ][  ][  ]
