[  ][B ][  ][B ][  ][  ][  ][  ][  ][Hr][  ][  ][  ][  ][  ][  ]
[B ][  ][Wu][  ][  ][  ][  ][  ][  ][  ][Wl][  ][Wl][  ][  ][  ]
[Wd][Wu][  ][  ][  ][  ][  ][  ][  ][  ][  ][  ][  ][D ][  ][Hu]
[  ][  ][  ][B ][  ][  ][  ][  ][Hu][  ][  ][  ][  ][Hr][  ][  ]
[  ][  ][  ][  ][Hd][  ][  ][  ][B ][  ][  ][  ][  ][  ][  ][Hr]
[  ][  ][B ][  ][  ][  ][  ][  ][  ][  ][  ][  ][  ][  ][  ][  ]
[  ][  ][  ][  ][  ][  ][  ][B ][  ][Ex][  ][  ][  ][  ][  ][  ]
[  ][  ][  ][  ][  ][  ][  ][B ][  ][  ][Wd][  ][  ][  ][Hd][B ]
[  ][B ][  ][  ][Wu][  ][  ][Hl][  ][B ][  ][  ][  ][  ][  ][  ]
