[  ][Hu][  ][  ][  ][Hu][  ][  ][  ][  ][B ][  ][Hd][  ][  ][  ]
[B ][Hu][Wd][  ][  ][  ][Wu][  ][  ][  ][  ][  ][  ][  ][  ][  ]
[  ][Wu][Hr][  ][B ][  ][  ][  ][Hl][  ][B ][  ][  ][D ][  ][  ]
[  ][  ][B ][  ][  ][B ][  ][  ][  ][  ][  ][  ][B ][  ][  ][  ]
[Wr][B ][  ][  ][  ][Wu][  ][  ][  ][Hl][Hr][Wl][  ][  ][  ][  ]
[  ][B ][Hr][  ][  ][  ][  ][Wr][  ][  ][  ][  ][  ][  ][  ][  ]
[  ][Wd][  ][  ][Wu][  ][B ][  ][Wu][Ex][  ][  ][B ][  ][  ][Wd]
[  ][Hu][  ][  ][  ][  ][B ][B ][Wu][  ][  ][  ][Hd][  ][Wr][  ]
[  ][  ][  ][  ][Wu][Hr][  ][  ][  ][  ][  ][Wr][Hl][  ][  ][  ]
