[  ][  ][  ][  ][  ][  ][  ][  ][  ][  ][  ][  ][  ][  ][  ][  ]
[  ][  ][  ][B ][  ][  ][  ][  ][  ][  ][  ][  ][  ][Hl][  ][  ]
[  ][  ][  ][  ][Wr][  ][B ][  ][  ][B ][  ][  ][  ][B ][Ex][  ]
[  ][  ][  ][  ][  ][  ][  ][  ][  ][D ][  ][  ][  ][  ][B ][  ]
[  ][  ][Hl][  ][  ][B ][  ][  ][  ][  ][  ][Wd][Hl][  ][  ][  ]
[Hl][B ][  ][  ][  ][  ][  ][  ][Wd][  ][B ][  ][  ][  ][  ][  ]
[  ][  ][  ][  ][  ][  ][  ][  ][  ][B ][B ][  ][  ][  ][  ][Wd]
[  ][  ][  ][  ][B ][  ][  ][Hr][  ][Wu][Hl][  ][  ][  ][Hl][B ]
[Hl][  ][  ][  ][  ][  ][  ][Wl][Wl][  ][  ][  ][  ][B ][B ][  ]
