[  ][Hu][  ][B ][  ][Hu][  ][  ][  ][  ][  ][  ][Hd][Wd][  ][  ]
[B ][  ][Wd][  ][  ][  ][  ][  ][  ][  ][  ][  ][  ][  ][  ][  ]
[  ][  ][  ][  ][  ][  ][  ][  ][  ][  ][B ][  ][  ][D ][  ][Hu]
[  ][  ][  ][  ][  ][B ][  ][B ][  ][  ][Wd][  ][  ][  ][  ][  ]
[  ][B ][  ][  ][  ][Wu][  ][  ][  ][Hl][Hr][Wl][  ][  ][  ][Wr]
[  ][B ][  ][  ][  ][  ][  ][  ][  ][  ][  ][  ][  ][  ][  ][  ]
[  ][Wd][  ][  ][  ][  ][B ][  ][Wu][Ex][  ][  ][B ][B ][  ][Wd]
[  ][Hu][  ][  ][  ][  ][B ][Wr][Wu][  ][  ][  ][  ][  ][Wr][  ]
[  ][Wu][  ][  ][Wu][Hr][  ][  ][  ][  ][  ][  ][  ][  ][Wu][  ]
