[  ][Hu][B ][B ][  ][Hu][  ][  ][  ][  ][  ][  ][Hd][  ][  ][  ]
[B ][  ][Wd][Hl][Wd][  ][  ][  ][  ][  ][B ][  ][  ][  ][  ][  ]
[  ][Wu][  ][  ][  ][  ][  ][  ][Hu][  ][B ][  ][  ][D ][  ][Hu]
[  ][  ][  ][  ][  ][B ][B ][  ][  ][B ][Hu][  ][  ][  ][  ][  ]
[  ][  ][Hl][  ][Hl][Hr][Hd][  ][Hd][Hl][B ][  ][  ][  ][  ][  ]
[  ][B ][  ][  ][  ][  ][  ][  ][  ][  ][  ][  ][  ][  ][  ][  ]
[  ][Hl][  ][  ][  ][  ][B ][  ][  ][Ex][  ][  ][B ][B ][B ][  ]
[  ][Hu][  ][  ][  ][  ][B ][Hr][  ][  ][Hr][  ][  ][  ][Wr][  ]
[  ][Wu][  ][Hl][  ][Hr][Hu][  ][  ][  ][  ][  ][Wl][  ][  ][  ]
