[Hd][Hu][  ][B ][  ][Hu][  ][  ][  ][  ][  ][  ][B ][Wd][  ][  ]
[B ][  ][Wd][B ][  ][B ][  ][  ][  ][B ][  ][  ][  ][  ][  ][  ]
[Hu][B ][  ][  ][  ][  ][  ][  ][  ][  ][B ][  ][  ][D ][  ][Hu]
[  ][  ][  ][  ][  ][B ][  ][B ][  ][  ][Hu][B ][  ][  ][  ][  ]
[  ][B ][  ][B ][  ][  ][Hu][  ][  ][Hl][  ][Wl][  ][Hu][B ][Hr]
[  ][B ][  ][  ][  ][  ][  ][  ][  ][Wu][  ][  ][  ][  ][  ][  ]
[Wu][Wd][  ][  ][  ][  ][  ][  ][Wu][Ex][  ][  ][B ][B ][Wd][Wd]
[  ][Hu][  ][  ][Wd][  ][B ][Wr][Wu][  ][  ][  ][  ][  ][Wr][  ]
[  ][Wu][  ][  ][Wu][Hr][  ][  ][  ][  ][  ][  ][Wu][  ][B ][  ]
