[  ][Hu][  ][  ][  ][  ][  ][  ][  ][  ][  ][  ][Hd][  ][  ][  ]
[B ][  ][  ][  ][  ][  ][  ][  ][  ][  ][  ][  ][  ][B ][  ][Hu]
[  ][Wu][  ][  ][  ][  ][  ][  ][  ][  ][  ][  ][  ][D ][  ][  ]
[  ][  ][  ][  ][  ][  ][  ][B ][  ][  ][  ][  ][  ][  ][B ][  ]
[  ][B ][  ][  ][  ][  ][  ][  ][  ][  ][  ][Wl][  ][  ][  ][Hr]
[  ][B ][  ][  ][  ][  ][  ][  ][  ][  ][  ][Hr][B ][Wu][  ][  ]
[Wu][  ][  ][  ][  ][  ][  ][  ][Wu][Ex][  ][  ][B ][  ][  ][Wd]
[  ][Hr][  ][  ][  ][  ][  ][  ][  ][  ][  ][  ][  ][  ][Wr][  ]
[  ][  ][  ][  ][Wu][Hr][  ][  ][  ][  ][  ][  ][  ][Hd][  ][  ]
