[  ][  ][  ][B ][B ][Hu][  ][  ][  ][  ][B ][  ][Hd][Wd][B ][  ]
[B ][Hu][Wd][  ][  ][  ][Wu][  ][  ][  ][  ][  ][  ][  ][  ][Hl]
[  ][Wu][  ][  ][B ][  ][  ][  ][Hl][  ][B ][  ][  ][D ][  ][Hu]
[Wl][  ][  ][  ][  ][B ][  ][B ][  ][B ][  ][  ][  ][  ][  ][  ]
[Wr][B ][B ][  ][  ][Wu][  ][  ][  ][Hl][Hr][Wl][  ][  ][  ][Hu]
[  ][B ][  ][  ][  ][  ][  ][  ][  ][  ][  ][  ][  ][  ][  ][  ]
[B ][Wd][  ][  ][Wu][  ][  ][  ][Wu][Ex][  ][  ][B ][B ][  ][Wd]
[  ][Hu][  ][  ][  ][  ][B ][Hr][Wu][  ][  ][  ][Hd][  ][Wr][  ]
[  ][Wu][  ][  ][Wu][Hr][  ][  ][  ][Wl][  ][Wr][Hl][  ][  ][  ]
