[  ][  ][  ][B ][  ][Wr][  ][  ][Wu][  ][  ][Wr][B ][  ][  ][  ]
[B ][  ][Wu][  ][  ][B ][  ][  ][Hd][  ][  ][  ][  ][Hu][Wd][  ]
[Wl][Hl][  ][  ][  ][  ][B ][  ][  ][  ][  ][  ][  ][D ][  ][Hd]
[  ][  ][  ][B ][  ][  ][  ][B ][  ][  ][  ][  ][  ][Hu][  ][  ]
[  ][  ][  ][Hr][  ][  ][  ][  ][  ][  ][Wu][Wu][  ][  ][  ][Hr]
[  ][  ][B ][Hd][  ][  ][Wu][  ][  ][  ][  ][Wr][  ][  ][Wl][  ]
[  ][  ][  ][  ][Hd][  ][  ][B ][  ][Ex][  ][  ][  ][B ][  ][  ]
[  ][  ][Wl][Wu][  ][  ][Hl][B ][  ][Hd][  ][  ][  ][  ][B ][  ]
[  ][  ][Wu][  ][  ][  ][  ][Hl][  ][  ][  ][  ][  ][  ][  ][  ]
