[  ][Hu][  ][  ][Wu][Hu][  ][  ][  ][  ][B ][  ][Hd][  ][  ][  ]
[B ][Hu][Wd][  ][  ][  ][  ][  ][  ][  ][  ][  ][  ][  ][  ][  ]
[  ][Wu][Hr][  ][  ][  ][  ][  ][Hl][  ][B ][  ][  ][D ][  ][Hu]
[  ][  ][  ][  ][  ][  ][  ][B ][Hl][  ][  ][  ][  ][  ][  ][  ]
[Wr][  ][  ][  ][  ][Wu][  ][  ][  ][Hl][Hr][Wl][  ][  ][  ][  ]
[  ][  ][  ][  ][  ][  ][  ][  ][  ][  ][  ][  ][  ][  ][  ][  ]
[B ][Wd][  ][  ][Wu][  ][B ][  ][Wu][Ex][  ][  ][B ][  ][  ][Wd]
[  ][Hu][  ][  ][  ][  ][B ][  ][Wu][  ][  ][  ][Hd][  ][Wr][  ]
[  ][Wu][  ][  ][Wd][Hr][  ][  ][  ][  ][  ][Wr][Hl][  ][Wl][  ]
