[  ][  ][  ][Hd][  ][  ][  ][  ][  ][  ][  ][  ][Hl][  ][  ][  ]
[  ][  ][D ][  ][  ][B ][  ][  ][  ][  ][  ][  ][  ][  ][  ][  ]
[  ][  ][  ][  ][Wd][Wd][  ][  ][  ][  ][  ][  ][Wd][  ][B ][  ]
[  ][  ][  ][  ][  ][  ][Hl][  ][  ][Hd][  ][  ][  ][  ][  ][  ]
[  ][  ][Wu][  ][  ][  ][  ][  ][  ][  ][  ][  ][  ][  ][  ][  ]
[  ][  ][  ][  ][  ][  ][  ][  ][B ][Ex][  ][  ][  ][  ][  ][  ]
[  ][Hr][  ][Hd][  ][  ][  ][  ][  ][  ][  ][  ][  ][  ][  ][  ]
[  ][  ][  ][Hl][  ][  ][  ][  ][  ][  ][  ][  ][  ][  ][  ][Hl]
[  ][  ][  ][  ][  ][  ][  ][  ][  ][  ][  ][  ][  ][  ][  ][  ]
