[  ][Hu][  ][B ][  ][Hu][  ][  ][  ][  ][  ][  ][Hd][  ][  ][  ]
[B ][  ][Wd][Hl][Wd][  ][  ][  ][  ][  ][B ][  ][  ][  ][  ][  ]
[  ][Wu][  ][  ][  ][  ][  ][  ][  ][  ][B ][  ][  ][D ][  ][Hu]
[  ][  ][  ][  ][  ][B ][B ][  ][  ][B ][Hu][  ][  ][  ][  ][  ]
[  ][  ][Hl][  ][Hl][Hr][Hd][  ][Hd][Hl][B ][  ][  ][  ][  ][  ]
[  ][B ][  ][  ][  ][  ][  ][  ][  ][  ][  ][  ][  ][  ][  ][  ]
[Wr][Hl][  ][Wr][  ][  ][B ][  ][  ][Ex][  ][  ][B ][B ][B ][  ]
[  ][Hu][  ][  ][  ][  ][B ][Hr][  ][  ][Hr][  ][  ][  ][Wr][  ]
[  ][Wu][  ][Hl][  ][Hr][Hu][  ][  ][  ][  ][  ][Wl][  ][  ][  ]
