[  ][Hu][  ][B ][  ][Hu][  ][  ][  ][  ][  ][  ][Hd][  ][  ][  ]
[B ][  ][Wd][  ][  ][  ][  ][  ][  ][  ][  ][  ][  ][  ][  ][  ]
[  ][Wu][  ][  ][  ][  ][  ][  ][  ][  ][B ][  ][  ][D ][  ][Hu]
[  ][  ][  ][  ][  ][B ][B ][  ][  ][  ][Hu][  ][  ][  ][  ][  ]
[  ][  ][Hl][  ][  ][Wu][Wl][  ][  ][Hl][B ][  ][  ][  ][  ][  ]
[  ][B ][  ][  ][  ][  ][  ][  ][  ][  ][  ][  ][  ][  ][  ][  ]
[Wu][Wd][  ][  ][  ][  ][B ][  ][  ][Ex][  ][  ][B ][B ][Wu][  ]
[  ][Hu][  ][  ][  ][  ][B ][Hr][  ][  ][Hr][  ][  ][  ][Wr][  ]
[  ][Wu][  ][  ][  ][Hr][  ][  ][  ][  ][  ][  ][  ][  ][  ][  ]
