[  ][  ][  ][Wu][Wu][  ][  ][  ][  ][  ][Wr][  ][Hd][  ][  ][  ]
[  ][  ][  ][  ][  ][  ][  ][Hd][  ][  ][  ][  ][  ][  ][B ][  ]
[B ][  ][  ][  ][  ][  ][  ][  ][  ][  ][Hd][Hd][  ][  ][  ][  ]
[  ][  ][  ][  ][  ][  ][  ][  ][  ][  ][  ][  ][  ][Hu][  ][  ]
[  ][  ][  ][  ][  ][Hl][  ][  ][  ][  ][  ][  ][D ][Hd][Wl][  ]
[B ][  ][Wr][  ][  ][  ][  ][  ][  ][  ][  ][  ][Wu][  ][  ][  ]
[  ][Wd][  ][  ][  ][  ][  ][  ][  ][  ][  ][B ][  ][Wr][  ][  ]
[  ][  ][  ][  ][  ][  ][  ][  ][  ][  ][  ][  ][Wl][  ][  ][  ]
[  ][  ][  ][  ][Hu][Ex][  ][  ][  ][  ][  ][  ][  ][  ][  ][B ]
