[  ][Hu][  ][B ][  ][  ][  ][  ][  ][  ][  ][B ][Hd][Wd][  ][  ]
[B ][  ][  ][  ][  ][  ][  ][  ][  ][  ][  ][  ][  ][  ][  ][  ]
[Wd][Wu][  ][  ][  ][  ][  ][  ][  ][  ][  ][  ][  ][D ][  ][  ]
[  ][  ][  ][  ][  ][B ][  ][B ][  ][  ][Wu][B ][  ][  ][  ][  ]
[  ][B ][  ][  ][  ][Wu][  ][  ][  ][  ][Hr][Wl][  ][  ][  ][Hr]
[  ][B ][  ][  ][  ][  ][  ][  ][  ][  ][  ][  ][  ][  ][  ][  ]
[Wu][  ][  ][  ][  ][  ][B ][  ][Wu][Ex][  ][B ][  ][B ][  ][Wd]
[  ][Hd][  ][  ][  ][  ][B ][  ][B ][  ][  ][  ][  ][  ][  ][  ]
[  ][Wu][  ][  ][Wu][Hr][  ][  ][  ][  ][  ][  ][  ][  ][Wu][  ]
