[  ][  ][  ][B ][  ][  ][  ][  ][Wu][  ][  ][  ][  ][  ][  ][  ]
[B ][  ][  ][  ][  ][  ][  ][  ][  ][  ][  ][  ][  ][  ][  ][  ]
[  ][Wu][  ][  ][  ][  ][  ][  ][  ][  ][  ][  ][  ][D ][  ][Hu]
[  ][  ][  ][B ][  ][  ][  ][B ][  ][  ][  ][  ][  ][Hr][  ][  ]
[  ][  ][  ][  ][  ][  ][  ][  ][  ][  ][  ][Hu][  ][  ][  ][Hr]
[  ][B ][  ][  ][  ][  ][  ][  ][  ][  ][  ][  ][  ][  ][  ][  ]
[  ][B ][  ][  ][  ][  ][  ][  ][  ][Ex][  ][  ][  ][  ][  ][  ]
[  ][  ][  ][  ][  ][  ][Hr][B ][  ][  ][  ][  ][  ][  ][Hu][  ]
[  ][  ][  ][  ][Wu][  ][  ][Hl][  ][  ][  ][  ][  ][  ][  ][  ]
