[  ][Hu][  ][B ][  ][  ][Wr][  ][  ][Wl][  ][B ][Hd][Wd][  ][  ]
[B ][  ][  ][  ][  ][  ][  ][  ][  ][  ][  ][  ][B ][  ][  ][  ]
[Wd][Wu][  ][  ][  ][  ][  ][  ][  ][  ][  ][  ][Wl][D ][  ][  ]
[  ][  ][  ][  ][  ][B ][  ][B ][  ][  ][Wu][B ][  ][B ][  ][  ]
[  ][B ][Wd][  ][  ][Wu][  ][  ][  ][  ][Hr][Wl][  ][  ][  ][Hr]
[Wr][B ][  ][  ][  ][  ][  ][  ][  ][  ][  ][  ][  ][  ][  ][  ]
[Wu][  ][  ][  ][  ][  ][Hu][  ][Wu][Ex][  ][B ][  ][Hl][  ][Wd]
[  ][Hd][  ][  ][  ][  ][B ][Hd][B ][  ][  ][  ][  ][  ][  ][  ]
[  ][Wu][  ][  ][Wu][Wu][  ][  ][  ][  ][  ][  ][  ][  ][Wu][Wr]
