[  ][Hu][  ][  ][  ][  ][  ][  ][  ][  ][  ][  ][Hd][Wd][  ][  ]
[B ][  ][  ][  ][  ][  ][  ][  ][  ][  ][  ][  ][  ][  ][  ][  ]
[Wd][Wu][  ][  ][  ][  ][  ][  ][  ][  ][  ][  ][  ][D ][  ][  ]
[  ][  ][  ][  ][  ][B ][  ][B ][  ][  ][  ][B ][  ][  ][  ][  ]
[  ][B ][  ][  ][  ][Wu][  ][  ][Hd][  ][Hr][Wl][  ][  ][  ][Hr]
[  ][B ][  ][  ][  ][  ][  ][  ][  ][  ][  ][  ][  ][  ][  ][  ]
[Wu][  ][  ][  ][  ][  ][  ][  ][Wu][Ex][  ][  ][Hd][  ][  ][Wd]
[B ][Hd][  ][  ][  ][  ][B ][Wr][B ][  ][  ][  ][  ][  ][Wr][  ]
[  ][Wu][  ][  ][Wu][Hr][  ][  ][  ][  ][  ][  ][  ][  ][  ][  ]
