[  ][  ][  ][Hu][  ][Wd][  ][  ][  ][  ][  ][  ][  ][  ][  ][  ]
[  ][  ][  ][B ][  ][  ][  ][  ][Wu][  ][  ][B ][  ][Hl][  ][  ]
[  ][  ][B ][  ][Wr][  ][B ][  ][  ][  ][  ][  ][  ][  ][Ex][  ]
[  ][Wr][  ][  ][  ][B ][  ][  ][  ][D ][Wd][  ][  ][  ][Hr][Hl]
[  ][  ][  ][  ][  ][B ][  ][  ][  ][  ][  ][Wd][Hl][  ][  ][  ]
[Hl][B ][  ][  ][  ][  ][  ][  ][Wd][  ][B ][  ][  ][  ][  ][  ]
[  ][  ][  ][  ][  ][  ][  ][  ][  ][  ][B ][  ][  ][  ][  ][Wd]
[  ][Wu][  ][  ][B ][  ][  ][Hr][  ][Wu][  ][  ][  ][B ][Hl][B ]
[Hl][  ][  ][  ][B ][  ][  ][Wl][  ][  ][  ][  ][  ][B ][B ][  ]
