[  ][Hu][  ][  ][  ][  ][  ][  ][  ][  ][  ][  ][Hd][  ][  ][  ]
[B ][  ][  ][  ][  ][  ][  ][  ][  ][  ][  ][Hr][  ][B ][  ][Hu]
[  ][Wu][  ][  ][  ][  ][  ][  ][  ][  ][  ][  ][  ][D ][  ][  ]
[  ][  ][  ][  ][  ][  ][  ][B ][  ][  ][  ][  ][  ][  ][  ][  ]
[  ][B ][  ][  ][  ][  ][  ][  ][Hd][  ][Hr][Wl][  ][  ][  ][Hr]
[  ][B ][  ][  ][  ][  ][  ][  ][  ][  ][  ][Hr][  ][Wu][  ][  ]
[Wu][  ][  ][  ][  ][  ][  ][  ][Wu][Ex][  ][  ][  ][  ][  ][Wd]
[  ][Hd][  ][  ][  ][  ][B ][  ][B ][  ][  ][  ][  ][  ][Wr][  ]
[  ][  ][  ][  ][Wu][Hr][  ][  ][  ][  ][  ][  ][  ][  ][  ][  ]
