[  ][Hu][  ][B ][  ][Hu][  ][  ][  ][  ][B ][  ][Hd][Wd][  ][  ]
[B ][Hu][Wd][  ][  ][  ][Wu][  ][  ][  ][  ][  ][  ][  ][  ][  ]
[  ][Wu][  ][  ][B ][  ][Hd][  ][Hl][  ][B ][  ][  ][D ][  ][Hu]
[Wl][  ][  ][  ][  ][B ][  ][B ][  ][  ][  ][  ][  ][  ][  ][  ]
[Wr][B ][B ][  ][  ][  ][  ][  ][  ][Hl][Hr][Wl][  ][  ][  ][Hu]
[  ][B ][  ][  ][  ][  ][Hd][  ][  ][  ][  ][  ][  ][  ][  ][  ]
[B ][Wd][  ][  ][Wu][  ][  ][  ][Wu][Ex][  ][  ][B ][B ][  ][Wd]
[  ][Hu][  ][  ][  ][  ][B ][Hr][Wu][  ][  ][  ][Hd][  ][Wr][  ]
[  ][Wu][  ][  ][Wu][Hr][  ][  ][  ][Wl][  ][Wr][Hl][  ][  ][  ]
