[  ][  ][  ][B ][Wl][Wr][  ][  ][Wu][  ][  ][  ][B ][  ][  ][  ]
[B ][  ][Wu][  ][  ][B ][  ][  ][Hd][  ][  ][  ][  ][Hu][  ][  ]
[Wl][  ][  ][  ][  ][  ][B ][  ][  ][  ][B ][  ][  ][D ][  ][Hd]
[  ][  ][  ][B ][  ][  ][  ][B ][  ][  ][  ][  ][  ][Hu][  ][  ]
[  ][  ][  ][Hr][  ][  ][Hl][  ][  ][  ][Wu][Wu][  ][  ][  ][  ]
[  ][  ][B ][  ][  ][  ][Wu][  ][  ][  ][  ][Wr][  ][  ][Wl][  ]
[  ][  ][  ][  ][Hd][  ][  ][B ][  ][Ex][  ][  ][  ][B ][  ][  ]
[  ][  ][Wl][Wr][  ][  ][Hl][B ][  ][Hd][  ][  ][  ][  ][B ][  ]
[  ][  ][Wu][  ][  ][  ][  ][Hl][  ][  ][  ][  ][  ][  ][B ][  ]
