[  ][  ][  ][Wu][Wu][  ][  ][  ][  ][B ][Wr][  ][  ][  ][  ][  ]
[  ][  ][  ][Hd][  ][  ][  ][Hd][  ][  ][  ][  ][  ][  ][B ][  ]
[B ][  ][  ][  ][  ][  ][Wd][  ][  ][  ][Hd][Hd][  ][  ][  ][  ]
[  ][  ][  ][  ][  ][  ][  ][Hd][  ][  ][  ][  ][  ][  ][  ][  ]
[  ][  ][  ][  ][  ][  ][  ][  ][  ][  ][  ][  ][D ][Hd][Wl][  ]
[  ][  ][Wr][  ][  ][  ][  ][  ][  ][  ][  ][  ][Wu][  ][  ][  ]
[  ][Wd][  ][  ][  ][  ][  ][  ][Hr][  ][  ][B ][  ][Wr][  ][  ]
[  ][  ][  ][  ][  ][  ][  ][Hu][  ][  ][  ][  ][Wl][  ][  ][  ]
[Hr][  ][  ][  ][Hu][Ex][  ][  ][  ][  ][  ][  ][  ][  ][  ][  ]
