[  ][Hu][  ][B ][B ][Hu][  ][  ][  ][  ][B ][  ][Hd][Wd][  ][  ]
[B ][Hu][  ][  ][  ][  ][Wu][  ][  ][  ][  ][  ][  ][Hd][  ][  ]
[  ][Wu][  ][  ][B ][  ][  ][  ][Hl][  ][B ][  ][  ][D ][  ][Hu]
[Wl][  ][  ][  ][  ][B ][  ][B ][  ][  ][  ][  ][  ][  ][  ][  ]
[Wr][B ][B ][  ][  ][Wu][  ][  ][  ][Hl][Hr][Wl][  ][  ][  ][Hu]
[  ][B ][  ][  ][  ][  ][  ][  ][  ][  ][  ][  ][  ][  ][  ][  ]
[B ][Wd][  ][  ][Wu][  ][B ][  ][Wu][Ex][  ][  ][B ][B ][  ][Wd]
[  ][Hd][  ][  ][  ][  ][B ][Hr][Wu][  ][  ][  ][Hd][  ][  ][  ]
[  ][Wu][  ][B ][Wu][Hr][  ][  ][  ][Wl][  ][Wr][Hl][  ][  ][  ]
