[  ][Hu][  ][  ][Wu][Hu][  ][  ][  ][  ][B ][  ][Hd][  ][  ][  ]
[B ][Hu][Wd][  ][  ][Hl][  ][  ][  ][  ][  ][  ][  ][Wd][  ][  ]
[  ][Wu][Hr][  ][B ][  ][  ][  ][Hl][  ][B ][  ][  ][D ][  ][Hu]
[  ][  ][  ][  ][  ][B ][  ][B ][  ][  ][  ][  ][  ][  ][  ][  ]
[Wr][  ][  ][  ][  ][Wu][  ][  ][  ][  ][Hr][Wl][  ][  ][  ][  ]
[  ][B ][  ][Hd][  ][  ][  ][  ][  ][  ][  ][  ][  ][  ][  ][  ]
[B ][Wd][  ][  ][Wu][  ][B ][  ][Wu][Ex][  ][  ][B ][  ][  ][Wd]
[  ][Hu][  ][  ][  ][  ][B ][  ][Wu][  ][Wr][  ][Hd][  ][Wr][  ]
[  ][Wu][  ][  ][Wd][Hr][  ][  ][  ][  ][  ][Wr][Hl][  ][Wl][  ]
