[  ][Hu][  ][B ][  ][Hu][  ][  ][  ][  ][  ][  ][Hd][  ][  ][  ]
[  ][  ][  ][  ][  ][  ][  ][  ][  ][  ][  ][  ][  ][  ][  ][  ]
[  ][  ][  ][  ][  ][  ][  ][  ][  ][  ][B ][  ][  ][D ][  ][Hu]
[  ][  ][  ][Wd][  ][Hl][  ][B ][  ][  ][Hu][B ][  ][  ][  ][  ]
[  ][B ][  ][  ][  ][  ][Wu][  ][  ][B ][  ][  ][  ][Hl][  ][Hr]
[  ][B ][  ][  ][  ][  ][  ][  ][  ][  ][  ][  ][  ][  ][  ][  ]
[Wu][Wd][  ][  ][  ][  ][B ][  ][Wu][Ex][  ][  ][  ][  ][  ][Wd]
[  ][Hu][  ][  ][  ][  ][B ][  ][Hr][  ][  ][  ][  ][  ][Wr][  ]
[  ][Hd][  ][B ][Wu][  ][  ][  ][  ][  ][  ][  ][  ][  ][Wu][  ]
