[Wl][Wu][  ][  ][Hu][Hr][Wr][  ][  ][B ][Hr][  ][Wl][Wl][  ][  ]
[  ][  ][Wu][  ][  ][Wu][  ][  ][B ][B ][  ][  ][  ][  ][  ][  ]
[  ][B ][  ][  ][  ][Hd][  ][  ][B ][  ][  ][  ][  ][  ][  ][Hl]
[  ][Wu][  ][  ][B ][  ][  ][  ][  ][  ][  ][  ][  ][  ][  ][  ]
[  ][  ][  ][  ][Hr][  ][  ][  ][  ][Wu][  ][  ][  ][  ][  ][B ]
[Hl][  ][B ][Wr][B ][  ][  ][  ][  ][Hr][  ][  ][  ][  ][  ][  ]
[Hl][  ][Hr][Ex][  ][B ][Hr][  ][  ][  ][  ][  ][B ][B ][B ][  ]
[  ][  ][  ][Hu][  ][  ][  ][  ][  ][  ][  ][  ][  ][  ][Hu][B ]
[Hu][  ][  ][  ][B ][D ][  ][  ][  ][Hl][  ][  ][B ][B ][Wd][Wu]
