[  ][B ][  ][  ][Hu][  ][  ][  ][  ][  ][  ][  ][Wl][  ][  ][  ]
[  ][  ][Wu][  ][  ][  ][B ][  ][  ][  ][  ][  ][  ][  ][  ][  ]
[  ][  ][  ][  ][  ][  ][  ][  ][  ][  ][  ][  ][  ][  ][  ][Hl]
[  ][  ][  ][  ][  ][  ][  ][Wl][  ][  ][  ][  ][  ][B ][  ][  ]
[  ][  ][  ][  ][Hr][  ][  ][  ][  ][  ][  ][  ][  ][  ][  ][  ]
[  ][  ][  ][Wr][Hu][  ][  ][  ][  ][Hr][  ][  ][  ][  ][  ][  ]
[Hl][  ][  ][Ex][  ][  ][  ][  ][  ][  ][  ][  ][  ][  ][  ][Hd]
[  ][  ][  ][  ][  ][  ][  ][  ][B ][  ][  ][  ][  ][  ][  ][  ]
[  ][  ][  ][  ][  ][D ][  ][  ][  ][  ][  ][  ][  ][  ][  ][  ]
