[  ][  ][  ][  ][Hu][  ][  ][  ][  ][  ][  ][  ][  ][  ][  ][  ]
[  ][  ][Wu][  ][  ][  ][  ][  ][  ][  ][  ][  ][Hu][  ][  ][  ]
[  ][  ][  ][  ][  ][Hd][  ][  ][B ][  ][Wl][Hd][  ][  ][Hl][  ]
[  ][  ][  ][  ][  ][  ][  ][  ][  ][  ][  ][  ][  ][  ][  ][  ]
[  ][  ][  ][  ][  ][  ][Wl][  ][  ][  ][  ][  ][  ][  ][  ][  ]
[  ][  ][  ][Wr][B ][  ][  ][  ][  ][Hr][  ][  ][  ][  ][  ][  ]
[Hl][  ][Hr][Ex][  ][  ][Wr][  ][Wu][  ][  ][  ][  ][  ][  ][  ]
[B ][  ][  ][B ][  ][  ][  ][  ][Wr][  ][  ][  ][  ][Wl][Hu][  ]
[  ][  ][  ][  ][  ][D ][  ][  ][  ][  ][  ][  ][  ][B ][Wd][  ]
