[  ][  ][  ][Wl][Hu][  ][  ][  ][  ][  ][  ][  ][  ][  ][Hu][  ]
[  ][  ][Wu][  ][  ][  ][  ][  ][  ][  ][  ][  ][Hu][Wl][  ][Hr]
[  ][B ][  ][  ][  ][Hd][  ][  ][  ][  ][Wl][Hd][  ][  ][B ][  ]
[  ][Wr][  ][  ][B ][Wl][  ][Hr][  ][  ][  ][  ][Wd][  ][  ][  ]
[  ][  ][  ][  ][Hr][B ][  ][  ][  ][  ][  ][  ][  ][  ][  ][  ]
[  ][  ][  ][Wr][B ][  ][  ][Wd][  ][  ][  ][  ][  ][  ][  ][  ]
[Hl][  ][  ][Ex][  ][  ][  ][Wl][  ][  ][  ][  ][  ][  ][  ][  ]
[  ][  ][  ][Hl][  ][  ][  ][  ][  ][Wr][  ][B ][  ][  ][Hu][  ]
[  ][  ][Hd][  ][B ][D ][  ][  ][  ][  ][Wr][  ][  ][  ][Wd][B ]
