[  ][Wd][Hr][Wd][Hl][Hr][  ][  ][  ][  ][  ][Wl][Wu][  ][Hu][  ]
[  ][  ][Hr][  ][Hr][  ][B ][  ][Hl][  ][  ][Wd][B ][Wl][  ][Hr]
[Wr][  ][Hr][  ][  ][Hd][  ][  ][B ][  ][  ][Hr][  ][  ][  ][  ]
[  ][Wr][Hu][  ][B ][Wl][B ][Hr][  ][B ][Hr][  ][Hl][Wd][Wd][B ]
[  ][Wd][  ][  ][  ][B ][  ][Wr][B ][  ][Hl][Hl][  ][  ][  ][B ]
[  ][  ][  ][Hr][B ][Wd][  ][Wd][  ][  ][  ][Wd][  ][B ][  ][  ]
[B ][  ][  ][Ex][  ][  ][  ][Wl][Wd][Wd][B ][  ][  ][  ][  ][  ]
[Wl][  ][  ][Wd][  ][  ][Hl][B ][  ][Wr][  ][B ][  ][  ][  ][  ]
[Wr][  ][  ][  ][B ][D ][  ][  ][Hd][B ][Wr][  ][  ][  ][Wd][B ]
