[  ][  ][  ][  ][Hu][  ][  ][  ][  ][B ][  ][B ][  ][  ][  ][  ]
[  ][  ][Wu][  ][  ][  ][  ][  ][  ][  ][  ][  ][Hu][  ][Wl][  ]
[  ][  ][  ][  ][  ][Hd][  ][  ][  ][  ][Wl][Hd][  ][  ][  ][Wr]
[  ][Wr][  ][  ][  ][Hu][  ][  ][  ][  ][B ][  ][  ][  ][  ][  ]
[  ][  ][Wu][Hd][  ][  ][  ][  ][  ][  ][Wu][  ][  ][  ][  ][B ]
[  ][  ][  ][Wr][B ][B ][  ][  ][  ][Hr][  ][  ][  ][  ][  ][B ]
[Hl][  ][Hr][Ex][  ][B ][  ][Wl][  ][  ][B ][  ][Hl][  ][  ][  ]
[B ][  ][  ][  ][  ][  ][  ][  ][  ][Wd][  ][  ][  ][  ][Hu][  ]
[  ][  ][  ][  ][B ][D ][  ][  ][  ][  ][  ][  ][  ][Wd][Wd][  ]
