[  ][  ][  ][  ][Hu][  ][  ][  ][  ][B ][Wu][B ][  ][  ][  ][  ]
[  ][  ][Wu][  ][  ][  ][  ][  ][  ][  ][  ][  ][Hu][  ][Wl][Hr]
[  ][  ][  ][Hd][  ][Hl][  ][  ][  ][  ][Wl][Hd][  ][B ][Hr][Wr]
[  ][B ][  ][  ][  ][Hu][  ][  ][  ][  ][Wu][  ][  ][  ][  ][  ]
[  ][  ][Wu][Hd][Wl][  ][  ][  ][  ][  ][  ][  ][  ][  ][  ][B ]
[Wl][  ][  ][Wr][B ][B ][Hd][  ][  ][Hr][  ][  ][  ][  ][  ][B ]
[Hd][  ][Hr][Ex][  ][B ][  ][Wl][  ][  ][B ][  ][Wr][  ][  ][B ]
[B ][  ][  ][  ][  ][  ][  ][  ][  ][  ][  ][  ][  ][  ][Wr][  ]
[  ][  ][  ][  ][B ][D ][  ][  ][Hd][  ][  ][  ][  ][Wd][Wd][  ]
