[  ][Hd][  ][Wl][Hu][Hr][  ][  ][  ][  ][  ][  ][  ][  ][Hu][  ]
[  ][  ][Wu][  ][  ][  ][  ][  ][  ][  ][  ][Wd][Hu][Wl][  ][Hr]
[Wr][B ][  ][  ][  ][Hd][  ][  ][  ][  ][Wl][Hd][  ][  ][  ][  ]
[  ][Wr][  ][  ][B ][Wl][  ][Hr][  ][Hl][  ][  ][Wd][Wd][  ][B ]
[  ][  ][  ][  ][Hr][B ][  ][  ][  ][  ][  ][  ][  ][  ][  ][  ]
[  ][  ][  ][Wr][B ][  ][  ][Wd][  ][  ][  ][  ][  ][B ][  ][  ]
[B ][  ][  ][Ex][  ][  ][  ][Wl][  ][  ][Wu][  ][  ][  ][  ][  ]
[  ][  ][  ][Hl][  ][  ][  ][  ][  ][Wr][  ][B ][  ][  ][Hu][  ]
[Wr][  ][Hr][B ][B ][D ][  ][  ][  ][  ][Wr][  ][  ][  ][Wd][B ]
