[  ][B ][Wl][Hl][Hu][Hr][  ][  ][  ][  ][  ][B ][Hu][  ][  ][  ]
[  ][Wr][  ][  ][Wd][  ][Hr][  ][  ][  ][  ][Wd][B ][Wl][  ][  ]
[Wr][B ][  ][  ][  ][Hd][  ][  ][  ][  ][Wl][  ][  ][Wu][  ][  ]
[  ][  ][  ][Hr][B ][Wl][  ][Wl][  ][Hl][  ][  ][Hd][  ][Wd][Wr]
[  ][  ][  ][  ][Hl][B ][B ][  ][  ][B ][  ][Hr][Wu][  ][  ][  ]
[B ][  ][  ][Hr][B ][  ][  ][Wd][Wd][  ][  ][Wd][Hr][B ][  ][Hu]
[  ][  ][  ][Ex][  ][  ][  ][Wl][Wd][Wd][  ][Wl][  ][  ][  ][Wl]
[  ][  ][  ][Hl][B ][  ][  ][  ][  ][Wd][  ][B ][  ][  ][  ][  ]
[Wr][B ][  ][  ][B ][D ][  ][Hu][  ][  ][Wr][B ][Wd][Hr][Hl][  ]
