[  ][B ][  ][  ][Hu][  ][  ][  ][  ][  ][  ][  ][Wl][  ][  ][  ]
[  ][  ][Wu][  ][  ][  ][B ][  ][  ][  ][  ][  ][  ][  ][  ][  ]
[  ][  ][  ][B ][  ][  ][  ][  ][  ][  ][  ][  ][  ][  ][  ][Hl]
[  ][  ][  ][  ][  ][  ][  ][Wl][  ][  ][  ][  ][  ][  ][  ][  ]
[  ][  ][  ][  ][Hr][  ][  ][  ][  ][  ][  ][  ][  ][  ][  ][  ]
[  ][  ][  ][Wr][Hu][  ][  ][  ][  ][B ][  ][  ][  ][  ][  ][  ]
[  ][  ][  ][Ex][  ][  ][  ][  ][  ][  ][  ][  ][  ][  ][  ][Hd]
[  ][B ][  ][  ][  ][  ][  ][  ][B ][  ][  ][  ][  ][  ][  ][  ]
[  ][  ][  ][  ][  ][D ][  ][  ][  ][  ][  ][  ][  ][  ][  ][  ]
