[D ][  ][  ][B ][  ][  ][  ][  ]
[  ][  ][Wu][  ][  ][  ][  ][Wl]
[  ][  ][  ][  ][B ][  ][  ][  ]
[  ][  ][  ][  ][  ][  ][Wu][  ]
[  ][  ][  ][  ][Wu][  ][  ][  ]
[  ][  ][  ][  ][B ][  ][  ][  ]
[Wl][  ][Wl][  ][  ][  ][Hr][  ]
[Wl][  ][  ][  ][Hd][  ][Wd][Ex]
