[D ][  ][  ][  ][Wu][  ][  ][  ]
[  ][  ][  ][Hu][  ][  ][Hr][  ]
[  ][Hu][  ][  ][  ][  ][  ][  ]
[Wl][  ][  ][  ][  ][  ][  ][  ]
[  ][  ][  ][Wl][  ][B ][Wr][  ]
[  ][  ][  ][  ][  ][  ][  ][  ]
[  ][  ][  ][B ][  ][  ][  ][  ]
[  ][  ][  ][  ][  ][  ][  ][Ex]
