[D ][  ][  ][  ][  ][Wu][  ][  ]
[Hl][  ][  ][  ][  ][  ][Wl][  ]
[  ][  ][  ][  ][B ][  ][Wl][  ]
[  ][  ][  ][B ][Hl][  ][  ][  ]
[B ][Wl][  ][  ][Wl][Wr][  ][  ]
[  ][  ][  ][  ][  ][B ][Wd][  ]
[  ][  ][B ][  ][  ][  ][  ][  ]
[  ][B ][B ][  ][Wl][Hr][  ][Ex]
