[D ][  ][  ][  ][  ][  ][  ][  ]
[  ][  ][Wu][  ][  ][  ][Wu][Wl]
[  ][  ][  ][B ][  ][Wl][Wr][  ]
[Wr][  ][  ][  ][  ][Hr][Hr][  ]
[  ][  ][Wu][  ][Wl][  ][  ][  ]
[  ][  ][  ][B ][  ][  ][  ][  ]
[  ][  ][  ][  ][B ][Wu][  ][  ]
[  ][  ][  ][  ][  ][  ][  ][Ex]
