[D ][  ][  ][  ][B ][Wu][  ][  ]
[  ][  ][Wr][  ][  ][Wl][  ][  ]
[Hl][  ][Wl][  ][  ][  ][  ][  ]
[  ][  ][B ][B ][Hd][  ][  ][  ]
[  ][  ][B ][  ][  ][Hu][  ][  ]
[  ][Hr][  ][  ][B ][B ][  ][  ]
[  ][  ][  ][  ][  ][  ][  ][  ]
[  ][  ][  ][  ][Wl][  ][  ][Ex]
