[D ][  ][  ][  ][  ][  ][  ][Wr]
[  ][  ][  ][  ][  ][B ][  ][  ]
[Wr][  ][  ][  ][  ][  ][  ][  ]
[B ][  ][  ][  ][  ][B ][  ][  ]
[  ][  ][  ][  ][  ][Wd][  ][B ]
[Hr][  ][Wl][Hl][  ][  ][  ][  ]
[  ][  ][Wd][  ][  ][  ][B ][  ]
[  ][Hd][  ][  ][  ][  ][  ][Ex]
