[D ][  ][B ][  ][  ][Wl][B ][  ]
[  ][  ][  ][  ][  ][  ][  ][  ]
[  ][Wd][  ][  ][  ][  ][Wu][B ]
[  ][  ][  ][  ][  ][  ][  ][  ]
[  ][Hl][B ][  ][  ][Wd][  ][  ]
[  ][  ][  ][  ][B ][  ][  ][  ]
[  ][  ][  ][  ][  ][  ][  ][B ]
[  ][B ][Wu][Wd][  ][  ][Wl][Ex]
