[D ][  ][  ][  ][Wu][  ][  ][  ]
[  ][  ][  ][Hu][  ][  ][Hr][Wl]
[  ][Hu][  ][B ][  ][  ][  ][  ]
[  ][B ][  ][  ][  ][  ][  ][  ]
[  ][  ][B ][Wl][  ][  ][Wd][  ]
[  ][  ][  ][  ][  ][  ][  ][  ]
[  ][  ][  ][  ][  ][B ][  ][  ]
[  ][  ][  ][  ][  ][  ][  ][Ex]
