[D ][  ][  ][  ][B ][Wu][  ][  ]
[  ][  ][  ][  ][  ][B ][  ][Hu]
[Wr][  ][Wl][  ][  ][  ][  ][  ]
[  ][  ][  ][  ][Hl][  ][B ][  ]
[  ][  ][  ][  ][  ][  ][  ][  ]
[  ][Hr][  ][  ][B ][B ][  ][  ]
[  ][B ][  ][  ][  ][Hl][B ][  ]
[  ][  ][  ][  ][Wl][  ][  ][Ex]
