[D ][  ][  ][  ][B ][Hu][Wu][Hu]
[  ][  ][Hd][  ][  ][  ][  ][Hu]
[Wr][  ][  ][  ][  ][  ][  ][  ]
[  ][  ][  ][  ][  ][  ][B ][  ]
[  ][B ][  ][  ][  ][Hu][  ][  ]
[  ][Hr][  ][  ][B ][B ][  ][  ]
[  ][  ][  ][  ][  ][  ][B ][  ]
[  ][  ][  ][B ][Wl][  ][  ][Ex]
