[D ][  ][  ][  ][  ][Wd][Hr][Wr]
[Hd][  ][  ][  ][  ][  ][  ][  ]
[Wr][  ][  ][  ][  ][  ][  ][  ]
[Hr][  ][  ][  ][  ][Hu][  ][  ]
[  ][  ][  ][  ][  ][  ][  ][B ]
[  ][  ][Wl][  ][B ][  ][  ][  ]
[Wu][  ][  ][  ][  ][  ][Hr][  ]
[  ][  ][  ][  ][Hd][Hl][  ][Ex]
