[D ][  ][  ][Wd][  ][  ][Hr][  ]
[  ][  ][  ][  ][  ][Wl][  ][  ]
[Wr][  ][  ][  ][  ][  ][  ][B ]
[B ][  ][  ][  ][  ][Hu][  ][  ]
[  ][  ][  ][B ][  ][  ][  ][  ]
[Hr][  ][Wl][  ][B ][  ][B ][  ]
[  ][  ][Wd][  ][  ][  ][  ][  ]
[  ][  ][  ][  ][  ][  ][  ][Ex]
