[D ][  ][B ][  ][  ][  ][  ][  ]
[Hl][  ][  ][  ][  ][  ][  ][  ]
[  ][Hd][  ][  ][  ][  ][  ][  ]
[  ][  ][  ][  ][  ][Hu][  ][B ]
[  ][  ][Wr][  ][  ][  ][  ][B ]
[  ][  ][B ][  ][B ][  ][  ][  ]
[  ][  ][  ][  ][  ][  ][  ][  ]
[B ][B ][  ][  ][  ][  ][  ][Ex]
