[D ][  ][  ][  ][  ][Wu][  ][  ]
[  ][  ][B ][  ][  ][  ][  ][  ]
[Wr][  ][Wl][  ][  ][B ][  ][  ]
[  ][  ][  ][B ][  ][  ][B ][  ]
[  ][  ][  ][  ][Wd][Hu][  ][  ]
[  ][  ][  ][B ][B ][B ][  ][  ]
[  ][B ][  ][  ][  ][Hl][B ][Hr]
[  ][  ][  ][  ][Wl][  ][  ][Ex]
