[D ][  ][  ][  ][B ][Wu][  ][Hu]
[  ][  ][  ][  ][  ][  ][  ][Hu]
[Wr][  ][Wl][  ][  ][  ][  ][  ]
[  ][  ][  ][  ][  ][  ][Wu][  ]
[  ][B ][  ][  ][  ][Hu][  ][  ]
[  ][Hr][  ][  ][B ][B ][  ][  ]
[  ][  ][  ][  ][  ][  ][B ][  ]
[  ][  ][  ][  ][Wl][  ][  ][Ex]
