[D ][  ][  ][  ][Wu][  ][  ][  ]
[  ][  ][  ][Hd][  ][  ][B ][Wl]
[Wu][Hl][  ][B ][B ][Wl][  ][  ]
[  ][  ][  ][  ][  ][Wr][  ][  ]
[  ][  ][  ][Wl][B ][B ][Wd][  ]
[  ][  ][  ][B ][  ][  ][  ][  ]
[  ][  ][  ][  ][  ][Hd][  ][  ]
[Wu][  ][  ][  ][  ][  ][  ][Ex]
