[D ][  ][  ][  ][  ][B ][  ][Hu]
[  ][  ][  ][  ][  ][  ][  ][  ]
[  ][  ][  ][  ][  ][B ][  ][  ]
[  ][Hu][  ][  ][  ][  ][B ][Hu]
[  ][  ][B ][  ][  ][  ][  ][  ]
[  ][Hr][B ][Wr][B ][  ][  ][Hu]
[  ][  ][Hr][  ][  ][Hl][B ][  ]
[  ][  ][  ][  ][Wl][  ][  ][Ex]
