[D ][  ][  ][  ][  ][Wu][Hr][  ]
[  ][  ][  ][  ][Wd][  ][  ][  ]
[  ][  ][  ][B ][  ][B ][Wl][  ]
[  ][  ][  ][B ][  ][B ][  ][  ]
[B ][Wl][  ][  ][  ][Wr][  ][  ]
[Hd][  ][  ][  ][  ][B ][  ][Hd]
[  ][  ][B ][  ][  ][  ][  ][  ]
[  ][Hr][B ][  ][B ][Hr][Wl][Ex]
