[D ][  ][  ][  ][  ][  ][Hr][  ]
[  ][  ][  ][  ][  ][B ][  ][  ]
[  ][  ][  ][  ][  ][Wd][  ][B ]
[B ][  ][  ][  ][  ][Hu][  ][  ]
[  ][  ][  ][B ][  ][  ][  ][B ]
[Hr][  ][Wl][Hl][B ][  ][  ][  ]
[  ][  ][Wd][  ][  ][  ][B ][  ]
[  ][  ][  ][  ][  ][  ][  ][Ex]
