[D ][  ][  ][  ][  ][Wu][  ][  ]
[  ][  ][Wr][  ][  ][Wl][B ][  ]
[  ][  ][  ][  ][B ][  ][  ][  ]
[  ][  ][  ][B ][  ][  ][  ][  ]
[  ][  ][  ][  ][  ][Hu][  ][  ]
[  ][  ][  ][  ][Wd][B ][  ][  ]
[  ][  ][B ][  ][Hd][  ][  ][  ]
[  ][  ][  ][  ][Wl][Hr][  ][Ex]
