[D ][  ][  ][  ][Wu][  ][  ][  ]
[  ][  ][  ][Hu][  ][  ][Hr][Wl]
[  ][Hu][  ][B ][  ][  ][  ][  ]
[  ][B ][  ][  ][  ][  ][  ][  ]
[  ][  ][  ][Wl][  ][B ][Wd][  ]
[  ][  ][  ][  ][  ][  ][  ][  ]
[  ][  ][  ][Hr][  ][  ][  ][  ]
[  ][  ][  ][  ][  ][  ][  ][Ex]
