[D ][  ][  ][  ][  ][  ][B ][  ]
[Wr][Wd][Wu][  ][Hr][  ][B ][  ]
[  ][  ][  ][  ][  ][  ][  ][  ]
[  ][Hd][  ][  ][  ][  ][  ][  ]
[  ][  ][B ][  ][  ][  ][  ][  ]
[  ][  ][Hr][  ][  ][  ][  ][  ]
[  ][  ][  ][  ][B ][  ][  ][  ]
[  ][  ][Wu][Wr][  ][  ][  ][Ex]
