[D ][  ][  ][  ][  ][  ][  ][  ]
[  ][  ][Wd][  ][  ][B ][  ][Wl]
[  ][  ][  ][  ][  ][  ][  ][  ]
[  ][  ][  ][  ][  ][  ][Wu][  ]
[  ][  ][  ][  ][  ][  ][  ][  ]
[Hr][  ][Wl][  ][B ][  ][  ][  ]
[  ][  ][  ][  ][  ][  ][Hr][  ]
[Wl][  ][  ][  ][B ][  ][Hl][Ex]
