[D ][  ][  ][  ][B ][Hu][B ][Hu]
[  ][  ][  ][  ][  ][  ][  ][Wd]
[Wr][  ][  ][  ][  ][  ][  ][  ]
[  ][  ][  ][  ][  ][  ][B ][  ]
[  ][  ][  ][  ][Wd][Hu][  ][  ]
[  ][  ][  ][B ][B ][B ][  ][  ]
[  ][B ][  ][  ][  ][Hl][  ][  ]
[  ][  ][  ][  ][Wl][  ][  ][Ex]
