[D ][Wu][  ][  ][  ][  ][B ][  ]
[Wr][Wd][Wu][  ][  ][  ][Wu][  ]
[  ][  ][  ][  ][  ][  ][  ][  ]
[Hd][  ][  ][  ][Wd][  ][  ][  ]
[  ][  ][Wu][  ][  ][  ][  ][  ]
[  ][  ][  ][  ][  ][  ][  ][  ]
[  ][  ][  ][  ][  ][Wu][  ][  ]
[  ][  ][  ][Wr][  ][  ][  ][Ex]
