[D ][  ][  ][  ][  ][  ][B ][  ]
[Wr][  ][Wu][  ][  ][  ][Wu][Wl]
[B ][  ][  ][  ][  ][  ][  ][  ]
[Hu][  ][  ][  ][  ][  ][B ][  ]
[  ][  ][Wu][  ][Wl][B ][  ][  ]
[  ][B ][  ][  ][  ][  ][  ][  ]
[  ][Hd][  ][  ][  ][Wu][  ][  ]
[Wl][Hr][  ][  ][  ][  ][Hl][Ex]
