[D ][  ][  ][  ][  ][  ][B ][  ]
[Wr][Wd][Wu][  ][  ][  ][Wu][Wl]
[  ][  ][  ][  ][  ][  ][Wr][  ]
[  ][  ][  ][  ][  ][  ][Hl][B ]
[  ][  ][  ][  ][Wl][  ][B ][  ]
[  ][  ][  ][Wd][  ][  ][  ][  ]
[  ][  ][  ][B ][  ][Wu][  ][  ]
[Wl][  ][  ][  ][  ][  ][  ][Ex]
