[D ][  ][  ][  ][  ][  ][  ][Hu]
[  ][  ][Wr][  ][  ][Wl][Hd][Hu]
[Wr][  ][Wl][  ][  ][  ][  ][  ]
[  ][  ][  ][B ][  ][  ][B ][  ]
[Hu][  ][  ][  ][  ][Wd][  ][  ]
[  ][Hr][  ][  ][B ][B ][  ][  ]
[  ][Wr][  ][  ][  ][  ][  ][  ]
[  ][  ][  ][  ][Wl][  ][  ][Ex]
