[D ][  ][  ][  ][  ][  ][  ][Hu]
[  ][  ][Hd][  ][  ][  ][  ][  ]
[  ][  ][  ][  ][  ][Hl][  ][  ]
[  ][  ][  ][  ][  ][  ][B ][  ]
[  ][  ][  ][  ][  ][Hu][  ][  ]
[  ][Hr][B ][  ][B ][B ][  ][  ]
[  ][  ][Hr][B ][  ][  ][B ][  ]
[  ][  ][  ][  ][  ][  ][  ][Ex]
