[D ][  ][  ][  ][B ][  ][  ][Hu]
[B ][  ][  ][  ][  ][  ][  ][  ]
[  ][  ][Wl][  ][  ][B ][  ][  ]
[  ][  ][  ][B ][B ][Wr][B ][  ]
[  ][  ][  ][  ][Wd][Hu][  ][  ]
[  ][  ][  ][B ][B ][B ][  ][  ]
[  ][B ][  ][  ][  ][Hl][  ][  ]
[  ][  ][  ][  ][Wl][  ][  ][Ex]
