[D ][  ][  ][  ][B ][  ][  ][Hu]
[  ][  ][  ][B ][B ][  ][  ][  ]
[Wr][Hl][  ][  ][Hr][  ][  ][B ]
[  ][  ][  ][Wd][  ][  ][  ][  ]
[B ][B ][  ][  ][  ][Hu][  ][  ]
[  ][Hr][  ][  ][B ][B ][Hu][B ]
[  ][  ][  ][  ][  ][  ][B ][  ]
[  ][Hl][  ][  ][  ][  ][  ][Ex]
