[D ][  ][  ][  ][  ][  ][  ][  ][  ][  ][  ][  ][  ][  ][  ][  ]
[  ][  ][  ][  ][  ][  ][  ][  ][  ][  ][  ][  ][  ][  ][  ][  ]
[  ][  ][B ][  ][  ][  ][  ][  ][  ][  ][  ][  ][Hr][  ][  ][  ]
[  ][  ][  ][  ][  ][  ][  ][  ][  ][  ][  ][Wd][Hu][  ][  ][  ]
[  ][  ][  ][B ][  ][  ][  ][  ][  ][  ][  ][  ][  ][  ][  ][  ]
[  ][  ][  ][  ][  ][  ][  ][  ][  ][  ][  ][  ][  ][  ][  ][  ]
[  ][  ][  ][  ][  ][  ][Hr][  ][  ][  ][  ][  ][  ][  ][  ][  ]
[  ][  ][  ][  ][  ][  ][  ][  ][  ][  ][  ][  ][  ][  ][  ][  ]
[  ][  ][  ][  ][  ][  ][  ][  ][  ][  ][  ][  ][  ][  ][  ][Ex]
