[D ][  ][  ][  ][  ][  ][  ][  ][  ][  ][  ][  ][  ][  ][  ][  ]
[  ][  ][  ][  ][Wr][  ][  ][  ][  ][  ][  ][Wd][  ][Hr][Wl][  ]
[  ][  ][  ][  ][  ][  ][  ][  ][  ][  ][  ][  ][Wl][  ][  ][  ]
[  ][  ][  ][  ][  ][  ][  ][  ][  ][  ][Hl][  ][  ][  ][  ][  ]
[  ][  ][  ][  ][  ][  ][  ][  ][  ][  ][  ][  ][  ][  ][  ][  ]
[  ][  ][  ][  ][  ][  ][  ][  ][  ][  ][  ][  ][  ][B ][  ][  ]
[  ][  ][  ][Wd][  ][  ][  ][  ][  ][  ][  ][  ][  ][  ][  ][  ]
[  ][  ][  ][  ][  ][  ][  ][  ][  ][  ][  ][  ][  ][  ][  ][  ]
[  ][  ][  ][  ][  ][  ][  ][  ][  ][  ][  ][  ][  ][  ][  ][Ex]
