[  ][Hu][  ][B ][  ][Hu][  ][  ][  ][  ][  ][Wl][Wd][Wd][  ][  ]
[B ][  ][B ][  ][  ][  ][  ][  ][  ][  ][  ][  ][  ][B ][  ][  ]
[  ][  ][  ][Hd][  ][  ][  ][  ][  ][  ][B ][  ][  ][D ][  ][Hu]
[  ][  ][  ][  ][B ][B ][  ][Hu][  ][  ][Wd][  ][  ][  ][  ][  ]
[  ][B ][  ][  ][  ][Wu][  ][  ][  ][Hl][Hr][Wl][  ][  ][  ][Hl]
[  ][B ][  ][  ][  ][  ][  ][  ][  ][  ][  ][  ][Wu][  ][  ][  ]
[  ][Wd][  ][  ][  ][  ][B ][  ][Wu][Ex][Hu][  ][B ][B ][  ][Wd]
[  ][Hu][  ][  ][  ][Wl][B ][Wr][Wu][  ][  ][  ][  ][  ][  ][  ]
[Hr][Wu][  ][  ][Wu][Hr][  ][  ][  ][Wd][  ][  ][  ][  ][Wu][B ]
