[  ][  ][  ][Wu][  ][  ][  ][  ][  ][  ][  ][  ][  ][  ][Hu][  ]
[Hu][  ][  ][  ][  ][  ][  ][Hd][Hr][  ][  ][  ][  ][  ][  ][  ]
[  ][  ][  ][  ][  ][  ][  ][  ][  ][  ][Hr][Hd][  ][  ][  ][  ]
[  ][B ][  ][  ][  ][  ][  ][  ][  ][  ][  ][Wl][  ][Wl][  ][  ]
[  ][  ][Hd][  ][  ][  ][  ][  ][  ][  ][  ][  ][D ][  ][  ][  ]
[  ][  ][Wr][  ][  ][  ][  ][  ][  ][  ][  ][  ][Wu][  ][  ][  ]
[  ][  ][  ][  ][Hr][Hr][  ][Wr][  ][  ][  ][  ][Wr][  ][  ][B ]
[  ][  ][  ][  ][  ][  ][  ][Hu][  ][  ][  ][  ][  ][  ][Wu][  ]
[Hu][  ][Wu][  ][  ][Ex][  ][  ][  ][  ][  ][  ][  ][  ][  ][  ]
