[  ][  ][  ][B ][  ][  ][  ][  ][Wd][  ][  ][  ][  ][  ][  ][  ]
[B ][  ][Wr][  ][  ][  ][Hl][  ][  ][  ][  ][  ][Wr][  ][  ][  ]
[  ][Wu][B ][  ][  ][  ][  ][  ][  ][  ][  ][  ][  ][D ][  ][Hu]
[  ][  ][  ][B ][  ][  ][  ][B ][  ][  ][  ][  ][  ][Hr][Hr][  ]
[  ][  ][  ][  ][  ][B ][  ][  ][  ][  ][  ][Hu][  ][  ][  ][Hr]
[  ][B ][  ][  ][  ][  ][  ][B ][  ][  ][  ][  ][  ][  ][  ][  ]
[  ][  ][  ][  ][  ][  ][Wu][B ][  ][Ex][  ][  ][  ][  ][  ][Hd]
[  ][  ][Wr][  ][Hd][  ][  ][B ][  ][  ][  ][  ][  ][  ][Hu][  ]
[  ][  ][  ][  ][Wu][  ][  ][Hl][B ][  ][  ][  ][  ][  ][  ][  ]
