[B ][  ][  ][B ][  ][  ][  ][  ][Wu][  ][Wu][  ][  ][  ][  ][B ]
[  ][  ][  ][Hu][  ][Hu][  ][  ][  ][  ][  ][  ][  ][  ][  ][  ]
[  ][Wu][  ][  ][  ][B ][  ][  ][  ][  ][Wd][  ][  ][D ][B ][Hu]
[  ][  ][  ][B ][  ][  ][  ][B ][  ][Wr][  ][  ][  ][  ][  ][  ]
[Hl][  ][B ][  ][  ][  ][  ][  ][  ][  ][  ][Hu][B ][  ][  ][Hr]
[  ][B ][  ][  ][  ][  ][  ][B ][  ][Hl][  ][  ][  ][Wu][  ][  ]
[  ][  ][Wl][  ][  ][  ][Hr][  ][  ][Ex][  ][  ][Wl][Wl][  ][  ]
[Hl][  ][  ][  ][Hr][  ][  ][Wd][Wl][B ][  ][  ][  ][  ][Hu][Wd]
[  ][Wl][  ][B ][Wu][Hd][  ][  ][  ][  ][  ][  ][B ][  ][  ][  ]
