[  ][Hu][B ][  ][Wu][Hu][  ][  ][  ][  ][Wu][Wd][Hd][  ][  ][  ]
[B ][Hu][Wd][  ][Wr][  ][  ][  ][Hl][  ][  ][  ][  ][  ][  ][  ]
[  ][Wu][Hr][Wl][B ][  ][  ][  ][  ][  ][  ][  ][  ][D ][  ][Hd]
[  ][  ][  ][  ][  ][  ][  ][B ][Wr][B ][  ][  ][Hl][  ][  ][  ]
[  ][  ][Hl][  ][  ][Wu][  ][  ][  ][Hl][Wd][Wl][  ][  ][B ][  ]
[  ][  ][  ][  ][  ][  ][  ][  ][  ][  ][  ][  ][  ][  ][  ][  ]
[B ][  ][  ][  ][Wu][  ][B ][B ][  ][Ex][  ][  ][B ][  ][  ][Hd]
[  ][Hu][  ][  ][  ][  ][B ][  ][Wu][  ][  ][  ][Hd][  ][Wr][  ]
[Wu][Wu][  ][  ][Wd][Hr][  ][  ][  ][  ][  ][Wr][Hl][  ][Wl][  ]
