[  ][Hu][  ][  ][  ][  ][  ][  ][  ][  ][  ][  ][B ][  ][B ][  ]
[B ][  ][  ][  ][  ][  ][Wd][  ][  ][  ][  ][  ][  ][B ][  ][Hu]
[  ][Wu][  ][  ][  ][  ][  ][  ][  ][  ][  ][  ][  ][D ][  ][  ]
[  ][  ][  ][Hu][  ][  ][  ][B ][  ][  ][B ][  ][  ][  ][B ][  ]
[  ][B ][B ][  ][Wl][  ][  ][  ][  ][  ][Hr][Wl][  ][  ][  ][Wd]
[  ][B ][  ][  ][  ][  ][  ][  ][B ][  ][B ][Hr][B ][Wu][  ][  ]
[Wu][  ][  ][  ][  ][  ][  ][B ][Wu][Ex][  ][  ][B ][  ][  ][Wd]
[  ][Hr][B ][  ][  ][  ][  ][  ][  ][  ][  ][  ][  ][  ][Wr][  ]
[  ][  ][  ][  ][Wu][Hr][  ][  ][  ][  ][Wr][Hl][  ][Hd][  ][  ]
