[  ][Hu][  ][  ][B ][  ][  ][  ][  ][  ][  ][  ][Hd][  ][B ][  ]
[B ][  ][Hl][  ][  ][  ][  ][  ][  ][  ][Wl][  ][B ][  ][  ][  ]
[Wd][Wu][  ][  ][  ][  ][  ][B ][  ][  ][  ][  ][  ][D ][  ][  ]
[  ][  ][  ][  ][  ][  ][B ][  ][  ][  ][  ][  ][Wl][  ][  ][  ]
[  ][B ][  ][  ][  ][  ][Wd][Wd][Hd][  ][Hr][Wl][  ][  ][  ][Hr]
[  ][B ][  ][  ][Hd][  ][  ][  ][  ][  ][  ][Hr][  ][Wl][  ][  ]
[Wu][  ][  ][Wd][B ][  ][  ][Wl][Wu][Ex][  ][  ][  ][  ][  ][Wd]
[  ][B ][  ][  ][  ][  ][B ][Wr][B ][  ][  ][  ][  ][  ][Wr][  ]
[  ][  ][  ][  ][Wu][Hr][  ][  ][  ][  ][  ][  ][  ][Wr][  ][Hr]
