[  ][Hu][  ][B ][  ][Hu][  ][  ][  ][  ][  ][Wl][Wd][Wd][  ][  ]
[B ][  ][B ][  ][  ][  ][  ][  ][  ][  ][  ][  ][  ][B ][  ][  ]
[  ][  ][  ][Hd][  ][  ][  ][  ][  ][B ][B ][  ][  ][D ][  ][Hu]
[  ][  ][  ][  ][B ][B ][  ][Hu][  ][  ][Wd][  ][  ][  ][  ][  ]
[  ][B ][  ][  ][  ][Wu][  ][  ][  ][Wr][Hr][Wl][  ][  ][  ][Hl]
[  ][B ][  ][  ][  ][  ][  ][  ][  ][  ][  ][  ][Wu][  ][  ][  ]
[  ][Wd][  ][  ][  ][  ][B ][  ][Wu][Ex][Hu][  ][  ][B ][  ][Wd]
[  ][Hu][  ][  ][  ][Wl][B ][Wr][Wu][  ][  ][  ][  ][  ][  ][  ]
[Hr][Wu][  ][  ][Wu][  ][  ][  ][  ][Wd][  ][  ][  ][  ][Wu][B ]
