[  ][Hu][  ][  ][  ][  ][  ][Wl][  ][  ][  ][  ][Hd][Wd][  ][  ]
[B ][  ][  ][  ][  ][  ][  ][  ][  ][  ][  ][  ][  ][  ][  ][  ]
[Wd][Wu][  ][  ][  ][  ][  ][  ][  ][  ][  ][  ][Wd][D ][  ][  ]
[  ][  ][  ][  ][  ][  ][  ][B ][  ][  ][  ][  ][  ][  ][  ][  ]
[  ][B ][Hr][  ][  ][  ][  ][  ][Hd][  ][  ][Wl][  ][  ][B ][Hr]
[Hd][B ][  ][  ][  ][  ][Wd][  ][  ][  ][  ][  ][  ][Wu][  ][Hl]
[Wu][  ][  ][  ][  ][  ][  ][  ][Wu][Ex][  ][  ][  ][  ][  ][Wd]
[  ][Hd][  ][  ][  ][  ][B ][Wr][B ][  ][  ][B ][  ][  ][Wr][  ]
[  ][  ][  ][  ][  ][Hr][  ][  ][  ][  ][  ][  ][  ][Hd][  ][  ]
