[  ][  ][  ][B ][  ][  ][  ][  ][Wd][  ][  ][  ][  ][  ][  ][  ]
[B ][  ][Wr][  ][  ][  ][Hl][  ][  ][  ][  ][  ][  ][  ][  ][  ]
[  ][Wu][  ][  ][  ][  ][  ][  ][  ][  ][B ][  ][  ][D ][  ][Hu]
[  ][  ][  ][B ][  ][B ][  ][  ][  ][  ][  ][  ][  ][Hr][Hr][  ]
[  ][  ][  ][B ][  ][B ][  ][  ][  ][  ][  ][Hu][  ][  ][  ][Hr]
[  ][B ][  ][  ][  ][  ][  ][B ][  ][  ][  ][  ][  ][  ][  ][  ]
[  ][  ][  ][  ][  ][  ][Wu][  ][  ][Ex][  ][  ][  ][  ][  ][Hd]
[  ][  ][Wr][  ][Hd][  ][  ][B ][  ][  ][  ][  ][  ][  ][Hu][  ]
[  ][  ][  ][  ][Wu][  ][  ][Hl][B ][  ][  ][  ][  ][  ][  ][  ]
