[  ][  ][  ][Wd][Hl][  ][  ][B ][  ][  ][  ][  ][  ][Wr][  ][  ]
[  ][  ][  ][  ][  ][B ][  ][  ][  ][  ][  ][  ][B ][  ][  ][  ]
[Hl][B ][  ][  ][  ][B ][  ][  ][Hu][  ][  ][  ][  ][  ][  ][  ]
[Wl][  ][Hl][  ][  ][B ][  ][Wu][  ][  ][  ][Wr][  ][  ][  ][  ]
[  ][  ][  ][B ][  ][  ][  ][Wl][  ][B ][  ][  ][  ][  ][  ][  ]
[  ][  ][  ][  ][  ][  ][  ][  ][  ][  ][  ][Wu][  ][  ][  ][  ]
[  ][  ][  ][Hu][  ][Wu][  ][  ][  ][  ][  ][  ][Wl][  ][D ][  ]
[  ][  ][  ][  ][  ][  ][  ][  ][  ][  ][  ][  ][Wl][  ][  ][  ]
[  ][Wr][Ex][  ][  ][  ][  ][  ][  ][  ][  ][  ][  ][  ][  ][Wu]
