[  ][Hu][  ][B ][  ][  ][  ][  ][  ][  ][B ][  ][Hd][Wd][  ][  ]
[B ][Hu][Wd][  ][  ][  ][Wu][  ][  ][  ][Hr][  ][  ][  ][  ][  ]
[  ][Wu][  ][  ][B ][  ][  ][  ][  ][  ][B ][  ][  ][D ][  ][Wd]
[Wl][  ][  ][  ][  ][B ][  ][B ][  ][  ][Hl][  ][  ][  ][  ][  ]
[Wr][Hl][  ][  ][  ][Wu][  ][  ][  ][Hl][Hr][Wl][  ][  ][  ][Hu]
[  ][B ][  ][  ][  ][  ][  ][  ][  ][  ][  ][  ][  ][  ][  ][  ]
[B ][Wd][  ][  ][Wu][  ][B ][  ][Wu][Ex][  ][  ][  ][  ][  ][Wd]
[  ][Hu][  ][  ][  ][  ][B ][  ][Wu][  ][  ][  ][Hd][  ][Wr][  ]
[  ][Wu][  ][  ][Wu][Hr][  ][  ][  ][  ][  ][Wr][Hl][B ][Wl][  ]
