[  ][Hu][  ][  ][  ][Hu][  ][  ][  ][  ][B ][  ][Hd][  ][  ][Hl]
[B ][  ][Wd][  ][  ][  ][Wu][  ][  ][  ][  ][  ][  ][  ][  ][  ]
[  ][Wu][Hr][  ][B ][  ][  ][  ][Hl][  ][B ][  ][  ][D ][  ][Hu]
[Wl][  ][  ][  ][  ][B ][Hu][B ][Hl][  ][  ][  ][  ][  ][  ][  ]
[Wr][B ][  ][  ][  ][Wu][  ][  ][  ][Hl][Hr][Wl][  ][  ][  ][  ]
[  ][B ][  ][  ][  ][  ][  ][  ][  ][  ][  ][  ][  ][  ][  ][  ]
[B ][Wd][  ][  ][Wu][  ][B ][Hd][Wu][Ex][  ][  ][B ][  ][  ][Wd]
[  ][Hu][  ][  ][  ][  ][Hr][B ][  ][  ][  ][  ][Hd][  ][  ][  ]
[  ][Wu][  ][  ][Wu][Hr][  ][  ][  ][  ][  ][  ][Hl][  ][Wl][  ]
