[B ][  ][  ][B ][  ][  ][  ][  ][Wu][  ][  ][  ][  ][  ][  ][  ]
[  ][B ][  ][  ][  ][Hu][  ][  ][  ][  ][  ][  ][  ][  ][  ][  ]
[  ][Wu][  ][  ][  ][B ][  ][  ][  ][  ][Wd][  ][  ][D ][Wl][Hu]
[  ][  ][  ][B ][  ][  ][  ][B ][  ][  ][  ][  ][B ][  ][  ][  ]
[  ][  ][B ][  ][  ][  ][  ][  ][  ][  ][  ][Hu][  ][  ][  ][Hr]
[  ][B ][  ][  ][  ][  ][  ][B ][  ][  ][  ][  ][  ][Wu][  ][  ]
[  ][  ][  ][  ][  ][  ][Hr][B ][  ][Ex][  ][  ][Wl][Wl][  ][  ]
[Hl][  ][  ][  ][B ][  ][  ][Wd][Wl][  ][  ][  ][  ][  ][Hu][  ]
[  ][Wl][  ][B ][Wu][  ][  ][  ][  ][  ][  ][  ][  ][  ][  ][  ]
