[  ][Hu][  ][B ][  ][Hu][  ][  ][  ][  ][  ][  ][Hd][  ][  ][  ]
[B ][  ][Wd][  ][  ][  ][  ][  ][  ][  ][  ][  ][  ][  ][  ][  ]
[  ][Wu][  ][  ][  ][  ][  ][  ][  ][  ][B ][  ][  ][D ][  ][Hu]
[  ][  ][  ][  ][  ][B ][  ][  ][  ][  ][Hu][B ][  ][  ][  ][  ]
[  ][  ][Hl][  ][  ][Wu][Wl][  ][  ][Hl][B ][  ][  ][  ][  ][  ]
[  ][B ][  ][  ][  ][  ][  ][  ][  ][  ][  ][  ][  ][  ][  ][  ]
[Wu][Wd][  ][  ][  ][  ][B ][  ][  ][Ex][  ][  ][B ][B ][Wu][  ]
[  ][Hu][  ][  ][  ][  ][B ][Wr][  ][  ][Hr][  ][  ][  ][Wr][  ]
[  ][Wu][  ][  ][Wu][Hr][  ][  ][  ][  ][  ][  ][  ][  ][  ][  ]
