[  ][  ][  ][B ][  ][  ][  ][  ][Wd][  ][  ][  ][  ][  ][  ][  ]
[B ][  ][Wr][  ][  ][  ][Hl][  ][  ][  ][  ][  ][  ][  ][  ][  ]
[  ][Wu][  ][  ][  ][  ][  ][  ][  ][  ][  ][  ][  ][D ][  ][Hu]
[  ][  ][  ][B ][  ][  ][  ][  ][  ][  ][  ][  ][  ][Hr][Hr][  ]
[Wd][  ][  ][B ][  ][B ][  ][  ][  ][  ][  ][Hu][  ][  ][  ][Hr]
[  ][B ][  ][  ][  ][  ][  ][B ][  ][  ][  ][  ][  ][  ][  ][  ]
[  ][  ][  ][  ][  ][  ][Wu][B ][  ][Ex][  ][  ][  ][  ][  ][Hd]
[  ][  ][Wr][  ][Hd][  ][  ][B ][  ][  ][  ][  ][  ][  ][Hu][  ]
[  ][  ][  ][  ][Wu][  ][  ][Hl][B ][  ][  ][  ][  ][  ][  ][  ]
