[  ][  ][  ][Wu][Wu][  ][  ][  ][  ][B ][Wr][  ][  ][  ][  ][  ]
[  ][  ][  ][Hd][  ][  ][  ][  ][  ][  ][  ][  ][  ][  ][B ][  ]
[  ][  ][B ][  ][  ][  ][Wd][  ][  ][  ][  ][Hd][  ][  ][  ][  ]
[  ][  ][  ][  ][  ][  ][  ][  ][  ][  ][  ][  ][  ][  ][  ][  ]
[  ][  ][  ][  ][  ][  ][  ][  ][  ][  ][  ][  ][D ][Hd][  ][  ]
[  ][  ][  ][Wu][  ][Wr][  ][  ][  ][  ][  ][  ][  ][  ][Hu][  ]
[  ][  ][  ][  ][  ][  ][  ][  ][Hr][  ][  ][B ][  ][Wr][  ][  ]
[  ][  ][  ][  ][  ][  ][  ][Hu][  ][  ][B ][  ][Wl][  ][  ][  ]
[Hr][  ][  ][  ][  ][Ex][  ][B ][  ][  ][  ][  ][  ][  ][  ][  ]
