[  ][Hu][  ][  ][  ][  ][  ][Wl][  ][  ][  ][  ][Hd][Wd][  ][  ]
[B ][  ][  ][  ][  ][  ][  ][  ][  ][  ][  ][  ][  ][  ][  ][  ]
[Wd][Wu][B ][  ][  ][  ][  ][  ][  ][  ][  ][  ][  ][D ][  ][  ]
[  ][  ][  ][  ][  ][  ][Hr][B ][  ][  ][  ][  ][  ][  ][  ][  ]
[  ][B ][Hr][  ][  ][  ][  ][  ][Hd][  ][  ][Wl][  ][  ][B ][Hr]
[Hd][B ][  ][  ][  ][  ][Wd][  ][  ][  ][  ][  ][  ][Wu][  ][  ]
[Wu][  ][  ][  ][  ][  ][  ][  ][Wu][Ex][  ][  ][  ][  ][  ][Wd]
[  ][Hd][  ][  ][  ][  ][B ][Wr][B ][  ][  ][B ][  ][  ][Wr][  ]
[  ][  ][  ][  ][  ][Hr][  ][  ][  ][  ][  ][  ][  ][Hd][  ][  ]
