[  ][Hu][  ][  ][  ][  ][  ][  ][  ][  ][  ][  ][B ][Wd][  ][  ]
[B ][  ][  ][  ][  ][B ][B ][  ][B ][  ][  ][  ][  ][  ][  ][  ]
[Wd][Wu][  ][  ][  ][B ][  ][  ][  ][  ][  ][  ][  ][D ][  ][  ]
[  ][  ][  ][  ][Hr][  ][Hr][B ][  ][  ][  ][Hd][  ][  ][  ][  ]
[  ][B ][  ][  ][  ][  ][  ][  ][Hd][  ][Wu][Hl][  ][  ][  ][Hr]
[  ][B ][  ][Hl][  ][  ][Hl][  ][  ][B ][  ][  ][  ][Wu][  ][  ]
[Wu][  ][  ][  ][  ][  ][  ][  ][B ][Ex][  ][  ][  ][  ][  ][Wd]
[  ][Hd][  ][  ][  ][  ][B ][Wr][B ][Hl][  ][  ][  ][  ][Wr][  ]
[  ][Wu][  ][  ][Wu][Hr][  ][Wr][  ][  ][  ][  ][  ][  ][  ][  ]
