[D ][  ][  ][  ][  ][  ][  ][Wr][  ][  ][Wr][  ][B ][  ][B ][  ]
[  ][  ][Hu][  ][  ][  ][  ][  ][  ][  ][  ][Wd][  ][  ][  ][  ]
[  ][  ][  ][  ][  ][  ][  ][  ][  ][  ][  ][  ][  ][  ][B ][  ]
[  ][  ][  ][  ][  ][  ][  ][  ][  ][  ][Wr][  ][  ][  ][  ][  ]
[  ][  ][  ][  ][  ][  ][  ][  ][  ][  ][  ][  ][Hd][  ][  ][  ]
[  ][  ][  ][  ][  ][  ][  ][  ][B ][  ][  ][  ][  ][Hr][  ][  ]
[  ][Wr][  ][  ][  ][  ][  ][B ][Wl][  ][B ][  ][  ][  ][Wl][  ]
[Wu][  ][  ][  ][  ][  ][  ][  ][  ][  ][  ][  ][  ][  ][  ][Wl]
[  ][  ][  ][B ][Hd][B ][  ][  ][  ][  ][B ][  ][  ][  ][  ][Ex]
