[D ][  ][  ][  ][  ][  ][  ][Wr][  ][  ][Wr][  ][B ][  ][B ][  ]
[  ][  ][  ][  ][  ][  ][B ][  ][  ][  ][  ][  ][  ][  ][  ][  ]
[  ][  ][Wu][  ][Hr][  ][  ][Hl][  ][  ][  ][  ][B ][B ][B ][  ]
[  ][  ][  ][  ][  ][  ][  ][  ][  ][  ][Wr][  ][  ][  ][  ][  ]
[  ][  ][  ][  ][  ][  ][  ][  ][  ][  ][  ][  ][Hd][  ][  ][  ]
[  ][  ][  ][  ][  ][  ][  ][  ][B ][  ][  ][  ][  ][Hr][  ][  ]
[  ][B ][  ][  ][  ][  ][  ][B ][Wl][  ][B ][  ][  ][  ][Wl][  ]
[Wu][  ][  ][  ][  ][  ][  ][  ][  ][  ][  ][  ][  ][  ][B ][Wl]
[  ][  ][  ][B ][Hd][B ][  ][Hl][  ][  ][B ][  ][  ][  ][  ][Ex]
