[D ][B ][  ][  ][  ][  ][B ][B ][  ][  ][  ][B ][  ][  ][  ][Hr]
[  ][  ][  ][  ][  ][  ][Wu][  ][Wl][  ][  ][Wd][  ][Wr][  ][  ]
[  ][  ][  ][  ][B ][  ][B ][  ][  ][B ][  ][  ][  ][  ][  ][  ]
[  ][  ][Wl][  ][  ][Wl][Hl][  ][Wd][  ][  ][Hu][  ][  ][  ][  ]
[  ][  ][  ][  ][  ][  ][B ][  ][  ][  ][B ][  ][Wu][  ][  ][  ]
[  ][  ][Wu][  ][  ][  ][  ][B ][  ][  ][B ][  ][  ][  ][  ][  ]
[  ][  ][  ][  ][  ][  ][  ][  ][  ][  ][B ][  ][  ][Hr][  ][B ]
[  ][Wr][  ][  ][Wl][  ][  ][  ][  ][  ][  ][  ][  ][  ][  ][  ]
[  ][  ][  ][B ][Wu][  ][  ][  ][  ][  ][  ][  ][  ][  ][  ][Ex]
