[D ][  ][  ][  ][  ][  ][  ][  ][  ][  ][  ][  ][  ][  ][  ][Wl]
[  ][  ][Hd][  ][  ][  ][  ][  ][Wl][  ][  ][Wd][  ][  ][  ][  ]
[  ][  ][  ][  ][Hr][  ][  ][  ][  ][B ][B ][  ][  ][  ][  ][  ]
[  ][  ][  ][  ][  ][  ][Wd][  ][  ][  ][  ][Hu][  ][  ][  ][  ]
[  ][  ][  ][  ][  ][  ][B ][  ][  ][Hr][  ][  ][B ][  ][  ][Wu]
[  ][  ][  ][  ][  ][  ][  ][  ][  ][  ][B ][  ][  ][  ][  ][  ]
[  ][Wr][  ][  ][  ][  ][  ][B ][Hu][  ][B ][  ][  ][  ][Hu][  ]
[Wu][  ][  ][  ][  ][  ][  ][B ][  ][  ][  ][  ][  ][  ][  ][  ]
[  ][Hl][Hd][B ][Hd][  ][  ][  ][  ][  ][  ][  ][  ][  ][  ][Ex]
