[D ][  ][  ][  ][B ][  ][Hd][Hl][  ][  ][  ][  ][  ][  ][Hl][Wl]
[  ][  ][  ][  ][  ][B ][  ][  ][B ][  ][  ][Wd][  ][  ][  ][B ]
[  ][  ][  ][  ][  ][  ][B ][Hl][B ][B ][B ][  ][  ][  ][  ][  ]
[B ][  ][  ][  ][  ][  ][  ][  ][  ][  ][  ][  ][  ][  ][B ][  ]
[  ][Hl][  ][Wl][B ][  ][  ][  ][  ][  ][  ][Wu][  ][  ][  ][Wu]
[  ][Wu][B ][  ][B ][  ][  ][  ][  ][  ][B ][  ][  ][  ][  ][  ]
[  ][  ][  ][Wr][Wr][  ][  ][B ][  ][  ][  ][  ][  ][Wu][  ][  ]
[  ][Wr][  ][  ][  ][  ][  ][Hu][  ][Hd][  ][  ][Hd][  ][  ][Hu]
[  ][  ][Hl][  ][  ][  ][Wl][Hd][  ][  ][  ][  ][  ][Wr][  ][Ex]
