[D ][  ][  ][  ][  ][  ][  ][  ][  ][  ][  ][  ][B ][  ][  ][Wl]
[  ][  ][  ][  ][  ][  ][  ][  ][  ][  ][  ][Wd][  ][  ][  ][  ]
[  ][  ][  ][  ][Hr][  ][  ][  ][  ][  ][  ][  ][  ][  ][B ][  ]
[  ][  ][  ][  ][  ][  ][Wd][  ][  ][  ][Wr][Hu][  ][  ][  ][  ]
[  ][  ][  ][  ][  ][  ][  ][  ][  ][  ][  ][  ][Hd][  ][  ][  ]
[  ][  ][  ][  ][  ][  ][  ][  ][B ][  ][  ][  ][  ][Hr][  ][  ]
[  ][Wu][  ][  ][  ][  ][  ][B ][Wl][  ][B ][  ][  ][  ][  ][  ]
[  ][  ][  ][  ][  ][  ][  ][  ][  ][  ][  ][  ][B ][Wu][  ][  ]
[  ][  ][  ][B ][Hd][  ][  ][Hd][  ][  ][  ][Wu][  ][  ][  ][Ex]
