[D ][  ][  ][  ][  ][  ][Hd][  ][  ][  ][  ][  ][  ][  ][Hl][Wl]
[  ][  ][  ][  ][  ][  ][  ][  ][Wl][  ][  ][Wd][  ][  ][  ][B ]
[  ][  ][B ][  ][  ][Hr][  ][  ][  ][B ][B ][  ][  ][  ][  ][  ]
[  ][  ][  ][  ][  ][  ][  ][  ][  ][  ][  ][Hu][B ][  ][B ][Hr]
[  ][B ][  ][  ][B ][  ][  ][  ][  ][  ][  ][Wu][B ][  ][  ][Wu]
[  ][  ][B ][  ][  ][  ][  ][  ][  ][  ][B ][  ][  ][  ][  ][  ]
[  ][Hu][  ][  ][Wr][  ][  ][B ][Hu][  ][  ][  ][  ][  ][  ][  ]
[Wu][Wr][  ][  ][  ][Hl][  ][B ][  ][  ][  ][  ][B ][  ][  ][  ]
[  ][  ][Hl][B ][  ][Hl][Wl][  ][  ][  ][  ][  ][  ][  ][Hl][Ex]
