[D ][  ][  ][  ][  ][  ][  ][  ][  ][  ][  ][B ][B ][  ][  ][  ]
[  ][Hr][Hr][  ][  ][  ][B ][B ][  ][  ][B ][  ][  ][  ][  ][B ]
[  ][  ][  ][  ][Hr][Hr][  ][  ][Wr][  ][  ][Hl][  ][  ][  ][  ]
[  ][  ][  ][  ][  ][  ][  ][  ][  ][  ][Hu][  ][B ][  ][  ][  ]
[  ][  ][  ][  ][  ][  ][  ][  ][  ][  ][Wr][  ][Hd][  ][  ][  ]
[  ][  ][  ][  ][  ][  ][  ][B ][  ][  ][  ][  ][Wu][  ][  ][  ]
[  ][  ][  ][  ][  ][  ][B ][  ][  ][  ][B ][  ][  ][  ][  ][  ]
[  ][  ][  ][  ][  ][  ][Wu][  ][  ][  ][  ][  ][  ][Wr][B ][Wl]
[  ][  ][  ][Wr][  ][  ][Wr][  ][  ][  ][  ][B ][  ][  ][  ][Ex]
