[D ][  ][  ][  ][  ][  ][  ][  ][  ][  ][  ][  ][  ][  ][Hl][  ]
[  ][  ][  ][  ][  ][  ][B ][  ][Wl][  ][  ][Wd][  ][  ][B ][B ]
[  ][  ][B ][  ][  ][Hr][  ][Wr][  ][B ][B ][  ][  ][  ][  ][Hr]
[  ][  ][  ][  ][  ][  ][  ][  ][  ][  ][  ][  ][B ][  ][B ][Hr]
[  ][B ][  ][  ][  ][  ][  ][  ][  ][  ][B ][Wr][B ][  ][  ][Wu]
[  ][Hu][  ][Wd][B ][  ][  ][  ][  ][Wr][B ][  ][  ][  ][  ][  ]
[  ][  ][  ][  ][  ][  ][  ][  ][  ][  ][  ][  ][  ][  ][  ][  ]
[Wu][Wr][  ][  ][  ][  ][  ][B ][  ][  ][  ][  ][  ][  ][B ][  ]
[  ][  ][B ][B ][B ][Hl][  ][  ][  ][  ][  ][  ][  ][  ][Hl][Ex]
