[D ][Wr][  ][  ][B ][  ][Hd][Hl][  ][  ][  ][  ][  ][  ][Hl][Wl]
[  ][  ][  ][  ][  ][B ][  ][  ][  ][  ][  ][Wd][  ][  ][  ][B ]
[  ][  ][  ][  ][  ][B ][B ][Hl][  ][B ][B ][  ][  ][  ][  ][  ]
[B ][  ][  ][  ][  ][  ][  ][  ][  ][  ][  ][  ][  ][  ][B ][Hr]
[  ][  ][  ][Wl][B ][  ][  ][  ][  ][  ][  ][Wu][  ][  ][  ][  ]
[  ][  ][Wu][  ][B ][  ][  ][  ][  ][  ][B ][  ][  ][  ][  ][  ]
[  ][  ][  ][  ][Wr][  ][  ][B ][  ][  ][  ][  ][  ][Wu][  ][B ]
[Wu][Wr][  ][Wl][  ][Wr][  ][B ][  ][  ][  ][  ][Hd][  ][  ][  ]
[  ][  ][  ][  ][  ][  ][Wl][Hd][  ][  ][  ][  ][  ][Wr][Hl][Ex]
