[D ][  ][Wd][  ][  ][  ][  ][  ][  ][  ][  ][Wd][  ][  ][  ][Wl]
[  ][  ][Hd][  ][  ][  ][Hd][  ][  ][  ][  ][Wd][  ][  ][  ][  ]
[  ][  ][Wr][  ][Hr][  ][  ][  ][  ][  ][  ][  ][  ][  ][  ][Wr]
[Hl][  ][  ][  ][  ][B ][Wd][  ][  ][  ][Wr][  ][  ][  ][  ][  ]
[  ][  ][  ][  ][Hl][  ][  ][  ][  ][Hr][B ][  ][B ][  ][  ][  ]
[  ][B ][  ][  ][  ][  ][  ][  ][B ][  ][  ][  ][  ][B ][  ][  ]
[  ][Wu][  ][  ][  ][  ][  ][B ][  ][  ][B ][  ][  ][  ][  ][  ]
[  ][  ][B ][  ][  ][  ][  ][  ][B ][  ][  ][  ][  ][Wu][  ][  ]
[  ][  ][Hd][B ][Hd][  ][  ][Hd][  ][  ][  ][  ][  ][  ][Wd][Ex]
