[D ][  ][  ][  ][  ][  ][  ][  ][  ][  ][Hd][  ][  ][  ][  ][Wl]
[  ][  ][  ][  ][  ][  ][  ][  ][Wl][  ][  ][Wd][  ][  ][  ][B ]
[  ][  ][  ][  ][Hr][  ][  ][  ][  ][  ][  ][  ][  ][  ][  ][  ]
[  ][  ][  ][  ][  ][  ][Wd][  ][B ][  ][  ][Hu][  ][  ][  ][  ]
[  ][  ][  ][  ][  ][  ][  ][  ][  ][Hr][  ][  ][B ][  ][  ][Wu]
[  ][  ][  ][  ][  ][  ][  ][  ][  ][  ][B ][  ][  ][  ][  ][  ]
[  ][  ][  ][  ][  ][  ][  ][  ][Hu][  ][B ][  ][  ][  ][  ][  ]
[Wu][B ][  ][  ][  ][  ][  ][B ][  ][  ][  ][  ][  ][  ][  ][  ]
[  ][  ][  ][B ][Hd][  ][  ][  ][  ][  ][  ][  ][  ][  ][  ][Ex]
