[D ][B ][  ][  ][  ][  ][B ][  ][  ][  ][  ][  ][  ][  ][  ][Hr]
[  ][  ][  ][  ][  ][  ][Wu][Hl][  ][  ][  ][  ][  ][Wr][  ][  ]
[  ][  ][  ][  ][  ][  ][B ][  ][  ][  ][  ][  ][  ][  ][  ][  ]
[  ][  ][Wl][  ][  ][Wl][Hl][  ][Wd][  ][  ][Hu][  ][  ][  ][  ]
[  ][  ][  ][  ][  ][  ][B ][  ][Wd][  ][B ][  ][Wu][  ][  ][  ]
[  ][  ][  ][  ][  ][  ][  ][B ][  ][  ][  ][  ][  ][  ][  ][  ]
[  ][  ][  ][  ][  ][  ][  ][  ][Wl][  ][Hr][  ][  ][Hr][  ][  ]
[  ][Wr][  ][  ][Wl][  ][  ][B ][  ][  ][  ][  ][  ][  ][  ][  ]
[  ][  ][Hd][B ][Wu][  ][  ][  ][  ][  ][  ][  ][  ][  ][  ][Ex]
