[D ][  ][  ][  ][B ][  ][Hd][Hl][  ][  ][  ][  ][  ][  ][Hl][Wl]
[  ][  ][  ][  ][  ][B ][  ][  ][  ][  ][  ][Wd][  ][  ][Hl][B ]
[  ][  ][  ][  ][  ][Wd][B ][Hl][  ][B ][B ][  ][  ][  ][  ][  ]
[B ][  ][  ][  ][  ][  ][  ][  ][  ][  ][  ][  ][  ][  ][B ][Hr]
[  ][  ][  ][Wl][  ][  ][  ][  ][  ][  ][  ][Wu][  ][  ][  ][Wu]
[  ][  ][B ][  ][B ][  ][  ][  ][  ][  ][B ][  ][  ][  ][  ][  ]
[  ][  ][  ][  ][Wr][  ][  ][  ][  ][  ][  ][  ][  ][Wu][  ][B ]
[Wu][Wr][  ][Wl][  ][Wr][  ][B ][  ][  ][  ][  ][Hd][  ][  ][  ]
[  ][  ][Hl][  ][  ][  ][  ][Hd][  ][  ][  ][  ][  ][Wr][Hl][Ex]
