[D ][  ][  ][Hu][  ][  ][B ][  ][  ][  ][  ][  ][B ][  ][Hr][Wl]
[  ][  ][  ][Wl][  ][  ][  ][  ][  ][  ][  ][Wd][  ][B ][  ][  ]
[  ][B ][  ][  ][  ][  ][  ][  ][  ][  ][  ][  ][  ][  ][B ][B ]
[  ][Wu][  ][  ][  ][  ][Wd][  ][Wr][  ][Wr][B ][  ][  ][  ][  ]
[  ][  ][  ][  ][  ][  ][  ][  ][Wd][Wd][  ][  ][Hd][  ][  ][  ]
[  ][  ][  ][Wl][  ][  ][  ][  ][Hl][  ][  ][  ][B ][Hr][  ][  ]
[  ][  ][B ][  ][  ][  ][  ][B ][Wl][  ][  ][  ][  ][  ][  ][  ]
[Wu][  ][  ][  ][  ][  ][  ][Wu][  ][  ][  ][  ][  ][  ][  ][  ]
[  ][  ][  ][B ][Hd][B ][  ][Wl][  ][  ][  ][  ][  ][  ][  ][Ex]
