[D ][  ][  ][  ][  ][  ][  ][  ][  ][  ][  ][  ][B ][  ][  ][  ]
[  ][Hr][Hr][  ][  ][  ][B ][B ][  ][  ][B ][  ][  ][  ][  ][B ]
[  ][  ][  ][  ][Hr][Hr][  ][  ][  ][  ][  ][Hl][  ][  ][  ][  ]
[  ][  ][  ][  ][  ][  ][  ][  ][  ][  ][Hu][  ][B ][  ][  ][  ]
[  ][  ][  ][  ][  ][  ][  ][  ][Wl][  ][Wr][  ][Hd][  ][  ][  ]
[  ][  ][  ][  ][  ][  ][  ][B ][  ][  ][  ][  ][Wu][  ][  ][  ]
[  ][  ][  ][  ][  ][  ][B ][  ][  ][  ][B ][  ][  ][  ][  ][  ]
[  ][  ][  ][  ][  ][B ][Wu][  ][  ][  ][  ][  ][  ][Wr][B ][Wl]
[  ][  ][  ][Wr][  ][  ][Wr][  ][  ][  ][  ][B ][  ][  ][  ][Ex]
