[D ][  ][B ][  ][  ][Wu][  ][  ]
[  ][  ][  ][  ][Wu][  ][  ][  ]
[  ][  ][  ][  ][  ][  ][  ][  ]
[  ][  ][  ][  ][  ][  ][  ][  ]
[  ][  ][B ][  ][  ][  ][  ][  ]
[  ][  ][  ][  ][  ][  ][B ][  ]
[  ][  ][B ][  ][  ][  ][  ][  ]
[  ][Hu][  ][  ][  ][  ][  ][Ex]
