[D ][  ][  ][  ][  ][  ][  ][  ]
[  ][  ][  ][  ][  ][  ][  ][  ]
[  ][  ][  ][Hu][  ][  ][  ][  ]
[  ][Hd][  ][  ][  ][  ][  ][  ]
[  ][  ][Hl][  ][  ][  ][  ][B ]
[  ][B ][  ][Wl][  ][  ][  ][  ]
[  ][  ][  ][  ][  ][  ][  ][  ]
[  ][  ][  ][  ][  ][  ][  ][Ex]
