[D ][  ][  ][  ][B ][  ][  ][  ]
[  ][  ][  ][  ][  ][  ][  ][  ]
[  ][  ][  ][B ][  ][  ][  ][  ]
[  ][  ][  ][Hu][  ][  ][  ][  ]
[  ][  ][  ][  ][  ][  ][  ][  ]
[  ][Wu][  ][  ][  ][  ][B ][  ]
[  ][B ][  ][  ][  ][  ][Wd][  ]
[  ][  ][  ][  ][  ][  ][  ][Ex]
