[D ][  ][Wu][  ][  ][  ][  ][  ]
[  ][  ][  ][  ][B ][  ][  ][  ]
[Hr][  ][  ][  ][  ][  ][  ][  ]
[  ][  ][  ][  ][  ][  ][B ][  ]
[  ][  ][  ][  ][  ][  ][  ][  ]
[  ][  ][  ][  ][  ][  ][  ][  ]
[  ][  ][  ][  ][  ][  ][  ][Wr]
[  ][  ][  ][B ][  ][  ][Hd][Ex]
