[D ][  ][  ][  ][  ][  ][  ][  ]
[  ][  ][  ][  ][  ][Wu][  ][  ]
[  ][Wr][  ][  ][  ][Hr][  ][  ]
[  ][  ][  ][  ][  ][Hd][  ][  ]
[  ][  ][  ][  ][  ][Hl][  ][  ]
[  ][  ][  ][  ][  ][  ][  ][  ]
[  ][  ][  ][  ][  ][  ][  ][  ]
[Hl][  ][  ][  ][  ][  ][  ][Ex]
