[D ][  ][  ][  ][  ][  ][  ][  ]
[  ][  ][  ][  ][  ][  ][  ][Wr]
[  ][  ][  ][  ][  ][  ][  ][  ]
[  ][  ][  ][Wl][  ][  ][  ][  ]
[  ][  ][  ][Hu][Wl][  ][  ][  ]
[Hu][  ][  ][  ][  ][  ][  ][  ]
[  ][  ][  ][Hr][  ][  ][  ][B ]
[  ][  ][  ][  ][  ][  ][  ][Ex]
