[D ][  ][  ][  ][  ][  ][  ][  ]
[  ][  ][  ][  ][  ][  ][  ][  ]
[  ][  ][  ][  ][  ][  ][  ][  ]
[  ][  ][  ][  ][  ][B ][Hl][  ]
[  ][  ][  ][  ][  ][  ][  ][B ]
[  ][  ][  ][  ][  ][  ][  ][  ]
[  ][  ][  ][  ][Wl][  ][  ][  ]
[  ][  ][  ][  ][  ][  ][  ][Ex]
