[D ][  ][  ][  ][  ][Wr][  ][  ]
[  ][  ][  ][  ][  ][  ][  ][  ]
[  ][  ][  ][  ][  ][Wl][  ][  ]
[  ][  ][Hd][  ][  ][B ][  ][  ]
[Wr][  ][  ][  ][  ][Hu][  ][  ]
[  ][  ][  ][  ][  ][  ][  ][  ]
[  ][  ][  ][  ][  ][  ][  ][  ]
[  ][  ][  ][  ][  ][  ][  ][Ex]
