[D ][  ][  ][  ][B ][  ][  ][  ]
[  ][  ][  ][  ][  ][B ][  ][  ]
[  ][  ][  ][  ][  ][Wd][  ][  ]
[  ][  ][  ][  ][  ][Hu][  ][  ]
[  ][  ][  ][  ][B ][  ][  ][  ]
[  ][  ][  ][  ][  ][  ][  ][  ]
[  ][B ][  ][  ][  ][  ][  ][  ]
[B ][  ][  ][  ][  ][  ][  ][Ex]
