[D ][  ][  ][  ][  ][  ][  ][  ]
[  ][  ][  ][  ][  ][  ][  ][  ]
[  ][  ][  ][Wd][  ][  ][  ][  ]
[  ][  ][  ][  ][B ][  ][Wl][  ]
[  ][  ][  ][  ][Wl][  ][  ][  ]
[  ][  ][  ][  ][  ][  ][  ][  ]
[  ][  ][  ][  ][  ][B ][B ][  ]
[  ][  ][  ][  ][  ][  ][  ][Ex]
