[D ][  ][  ][  ][  ][  ][  ][  ]
[  ][  ][  ][  ][  ][  ][  ][  ]
[  ][  ][  ][  ][  ][  ][  ][  ]
[  ][  ][  ][  ][  ][  ][  ][  ]
[  ][  ][  ][  ][  ][  ][Wr][  ]
[  ][  ][Hl][  ][  ][Wd][  ][  ]
[B ][  ][  ][  ][  ][  ][  ][  ]
[  ][  ][  ][  ][Hl][Hu][  ][Ex]
