[D ][  ][  ][  ][  ][  ][  ][  ]
[  ][B ][B ][  ][  ][  ][Wr][  ]
[  ][Hd][  ][  ][B ][  ][Hu][  ]
[  ][  ][  ][  ][  ][  ][  ][  ]
[  ][  ][  ][  ][  ][Hl][  ][  ]
[Wr][  ][  ][  ][  ][  ][  ][  ]
[  ][  ][  ][  ][  ][  ][  ][  ]
[  ][  ][  ][  ][  ][  ][  ][Ex]
