[D ][  ][  ][  ][  ][  ][  ][  ]
[  ][B ][B ][  ][  ][  ][  ][  ]
[  ][  ][  ][  ][  ][  ][  ][  ]
[  ][  ][  ][  ][  ][  ][  ][  ]
[  ][  ][  ][  ][  ][Hl][  ][  ]
[  ][  ][  ][  ][Hr][  ][  ][  ]
[  ][  ][Hu][  ][  ][  ][  ][  ]
[  ][  ][  ][  ][  ][  ][  ][Ex]
