[D ][  ][  ][  ][  ][  ][  ][  ]
[B ][  ][  ][  ][  ][  ][  ][  ]
[  ][  ][  ][  ][Wu][  ][  ][  ]
[B ][  ][  ][  ][  ][  ][  ][  ]
[  ][  ][  ][  ][  ][  ][  ][  ]
[  ][  ][  ][  ][  ][  ][  ][  ]
[  ][  ][Wd][  ][  ][Hu][  ][  ]
[B ][  ][  ][  ][  ][  ][  ][Ex]
