[D ][  ][  ][  ][  ][  ][  ][  ]
[  ][  ][  ][  ][  ][Wu][  ][  ]
[  ][  ][  ][  ][  ][Hr][  ][  ]
[  ][  ][  ][  ][  ][Hd][  ][  ]
[  ][  ][  ][  ][  ][  ][  ][B ]
[  ][  ][  ][  ][  ][  ][  ][  ]
[  ][  ][  ][  ][  ][Wu][  ][  ]
[Hl][  ][  ][  ][  ][  ][  ][Ex]
