[D ][  ][  ][  ][  ][  ][  ][Wl]
[  ][  ][  ][  ][  ][  ][  ][  ]
[  ][B ][  ][  ][  ][  ][  ][  ]
[  ][Hr][  ][B ][  ][  ][  ][  ]
[  ][  ][  ][  ][  ][  ][  ][  ]
[  ][  ][  ][  ][  ][  ][  ][  ]
[B ][  ][  ][  ][  ][  ][  ][  ]
[  ][  ][  ][  ][  ][Hr][  ][Ex]
