[D ][  ][  ][  ][Wu][  ][  ][  ]
[  ][  ][  ][  ][  ][  ][  ][  ]
[  ][  ][  ][  ][  ][  ][  ][  ]
[  ][  ][  ][  ][  ][  ][  ][  ]
[  ][  ][  ][Wu][  ][  ][  ][  ]
[  ][  ][  ][Hl][B ][  ][  ][  ]
[  ][  ][  ][  ][  ][  ][Wr][  ]
[  ][  ][  ][B ][  ][  ][  ][Ex]
