[D ][  ][  ][  ][  ][  ][  ][  ]
[  ][  ][  ][  ][  ][  ][  ][  ]
[  ][  ][  ][  ][  ][  ][  ][  ]
[  ][  ][  ][  ][  ][  ][  ][  ]
[  ][  ][Wr][  ][Hr][B ][  ][  ]
[  ][  ][  ][B ][  ][  ][B ][  ]
[  ][  ][  ][Hu][  ][  ][  ][Hr]
[  ][  ][  ][  ][  ][  ][  ][Ex]
