[D ][  ][  ][  ][  ][B ][  ][  ]
[  ][  ][  ][  ][  ][  ][  ][  ]
[  ][  ][Wr][Wd][  ][  ][  ][  ]
[  ][  ][  ][  ][  ][  ][  ][  ]
[  ][  ][  ][  ][  ][  ][  ][  ]
[  ][Wd][  ][  ][  ][  ][  ][  ]
[B ][Hu][  ][  ][B ][  ][  ][  ]
[  ][  ][  ][  ][  ][  ][  ][Ex]
