[D ][  ][Wu][  ][  ][  ][B ][  ]
[  ][  ][  ][  ][  ][  ][  ][B ]
[  ][  ][  ][  ][  ][  ][  ][  ]
[  ][  ][  ][  ][  ][  ][  ][  ]
[  ][Wr][  ][  ][  ][  ][  ][  ]
[  ][  ][  ][  ][  ][  ][Hu][  ]
[  ][  ][  ][  ][Wu][  ][  ][  ]
[  ][  ][  ][  ][  ][  ][  ][Ex]
