[D ][  ][  ][  ][  ][  ][  ][Wr]
[  ][Hd][  ][Wd][  ][  ][  ][  ]
[  ][  ][  ][  ][  ][Hd][  ][  ]
[  ][  ][  ][  ][  ][  ][  ][  ]
[  ][  ][  ][  ][  ][  ][  ][  ]
[  ][  ][  ][  ][B ][  ][  ][  ]
[  ][  ][  ][  ][  ][  ][Wr][  ]
[  ][  ][  ][  ][  ][  ][  ][Ex]
