[D ][  ][  ][  ][  ][  ][  ][  ]
[  ][  ][  ][  ][  ][  ][  ][  ]
[  ][  ][  ][  ][  ][  ][  ][  ]
[  ][  ][  ][  ][  ][  ][  ][  ]
[  ][  ][B ][  ][  ][  ][  ][B ]
[  ][  ][  ][Wl][  ][  ][  ][  ]
[  ][Wu][B ][B ][  ][  ][  ][  ]
[  ][  ][  ][  ][  ][Wu][  ][Ex]
