[D ][  ][  ][  ][  ][  ][  ][  ]
[  ][  ][  ][  ][  ][  ][  ][  ]
[  ][  ][  ][Wr][  ][  ][B ][B ]
[  ][  ][  ][  ][  ][  ][  ][  ]
[  ][  ][  ][  ][  ][  ][  ][  ]
[  ][  ][Hr][  ][  ][  ][  ][  ]
[  ][  ][Hu][  ][  ][  ][  ][  ]
[  ][  ][  ][  ][  ][  ][  ][Ex]
