[B ][  ][B ][B ][Hl][Hu][  ][B ][Wu][B ][  ][  ][  ][Hd][  ][Hr]
[  ][  ][  ][Wd][B ][Wr][  ][B ][  ][  ][  ][B ][  ][Wl][  ][Hu]
[Wl][  ][  ][Hl][  ][  ][  ][  ][  ][  ][  ][B ][  ][  ][  ][B ]
[  ][Wd][Wd][Wd][  ][  ][Wu][Wl][D ][  ][Wd][  ][  ][  ][  ][Hu]
[  ][  ][  ][B ][  ][B ][  ][  ][  ][  ][  ][  ][  ][  ][  ][  ]
[  ][  ][Wd][  ][Hu][  ][Hl][Ex][  ][  ][Hu][  ][Wl][  ][  ][Wu]
[B ][  ][B ][Hd][Wr][Hu][  ][  ][  ][  ][  ][B ][B ][  ][B ][  ]
[  ][  ][  ][  ][B ][  ][  ][  ][  ][  ][  ][Wl][  ][Wd][  ][  ]
[  ][  ][  ][B ][  ][Hd][  ][  ][  ][  ][Wl][Wd][  ][Wr][  ][  ]
