[  ][Wr][  ][Hr][Hl][Hu][Hd][  ][Wu][  ][Hr][Wr][Wr][Hd][  ][B ]
[  ][B ][B ][  ][  ][  ][B ][B ][B ][  ][  ][B ][  ][B ][  ][Hu]
[B ][  ][  ][  ][  ][  ][Hd][  ][Wl][  ][  ][B ][  ][  ][  ][B ]
[  ][  ][Wd][  ][  ][Wr][Wu][  ][D ][  ][Wl][  ][  ][  ][  ][Hu]
[  ][Hu][  ][B ][  ][B ][  ][Wl][  ][  ][  ][  ][  ][  ][  ][B ]
[  ][  ][  ][B ][  ][  ][  ][Ex][  ][  ][  ][Wl][  ][  ][  ][Wu]
[  ][  ][Hr][Wd][  ][  ][  ][Wr][Hd][B ][  ][  ][B ][B ][B ][  ]
[  ][  ][  ][  ][B ][Hl][Hd][  ][  ][  ][  ][Wl][  ][B ][  ][Wl]
[  ][  ][  ][  ][B ][Wu][  ][Hd][B ][Hu][Wl][Wd][Wr][Hr][Hr][  ]
