[  ][  ][B ][B ][Hl][Hu][  ][  ][Wu][  ][Hr][Wu][  ][Hd][  ][B ]
[  ][  ][Hr][Wd][  ][Wr][  ][B ][  ][  ][  ][B ][  ][Wu][  ][Hu]
[Wl][  ][B ][  ][  ][  ][  ][  ][  ][  ][  ][B ][Hu][  ][  ][B ]
[  ][Wd][Wd][  ][  ][  ][Wu][Wl][D ][  ][Wd][  ][  ][  ][Wd][Hu]
[  ][  ][  ][B ][  ][B ][  ][  ][  ][  ][  ][  ][  ][  ][  ][B ]
[  ][  ][  ][  ][  ][  ][Hl][Ex][  ][  ][Wd][  ][  ][  ][  ][Wu]
[  ][  ][B ][Wu][  ][Hl][  ][  ][  ][  ][B ][B ][B ][B ][B ][  ]
[  ][  ][  ][  ][  ][  ][Hd][  ][  ][  ][  ][  ][  ][Wd][  ][  ]
[Wr][  ][  ][B ][  ][Hd][B ][  ][B ][  ][Wd][Wd][Hd][B ][Hr][  ]
