[  ][Wr][B ][Hr][B ][Wr][Hd][  ][Wu][  ][Hr][B ][Wr][Hd][  ][B ]
[  ][B ][B ][Wd][  ][  ][B ][B ][B ][Hr][  ][B ][  ][  ][  ][Hu]
[B ][  ][Wl][  ][Wl][  ][Hd][  ][Wl][  ][  ][B ][  ][  ][  ][B ]
[  ][  ][Wd][  ][B ][Wr][B ][  ][D ][  ][Wl][  ][  ][  ][  ][Hu]
[  ][Hu][  ][B ][  ][Wu][  ][Wl][  ][  ][  ][  ][  ][  ][  ][B ]
[  ][  ][  ][B ][  ][  ][  ][Ex][  ][  ][B ][Wl][  ][  ][  ][Wu]
[  ][  ][Hr][Wd][  ][  ][  ][Wr][B ][B ][  ][  ][B ][B ][  ][  ]
[Wu][  ][  ][  ][B ][Hl][  ][  ][  ][  ][Wl][Wl][  ][Wd][  ][Wl]
[Wr][  ][  ][Hr][B ][Wu][  ][B ][  ][Wl][Wl][Wd][Wr][  ][B ][  ]
