[  ][  ][  ][  ][  ][  ][  ][  ][  ][  ][  ][  ][  ][  ][  ][  ]
[  ][  ][  ][Wd][  ][  ][Wr][  ][  ][  ][  ][B ][  ][  ][  ][  ]
[Wl][  ][B ][  ][  ][  ][  ][  ][  ][Hd][  ][  ][  ][  ][  ][  ]
[  ][Wu][  ][  ][  ][Hd][  ][  ][D ][  ][  ][  ][  ][  ][Wd][  ]
[  ][  ][  ][  ][  ][  ][  ][  ][  ][  ][  ][  ][  ][  ][  ][B ]
[  ][  ][  ][  ][  ][  ][  ][Ex][  ][  ][  ][  ][  ][  ][  ][  ]
[  ][Wr][B ][  ][  ][  ][  ][  ][  ][  ][B ][  ][B ][  ][  ][  ]
[  ][  ][  ][  ][  ][  ][  ][  ][  ][  ][  ][  ][  ][Wd][  ][  ]
[  ][  ][  ][  ][  ][  ][  ][  ][B ][  ][  ][  ][  ][B ][  ][  ]
