[  ][Wr][  ][Hr][Hl][Hu][Hd][  ][Wu][  ][Hr][B ][Hd][Hd][  ][  ]
[  ][B ][B ][Wd][  ][  ][B ][B ][B ][  ][  ][B ][  ][B ][  ][Hu]
[B ][  ][  ][  ][B ][  ][Hd][  ][Wl][  ][  ][B ][  ][  ][  ][B ]
[  ][  ][Wd][  ][  ][Wr][B ][  ][D ][  ][Wl][  ][  ][  ][  ][Hu]
[  ][Hu][  ][B ][  ][B ][  ][Wl][  ][  ][  ][  ][  ][  ][  ][Wl]
[  ][  ][  ][B ][  ][  ][  ][Ex][  ][  ][  ][Wl][  ][  ][  ][Wu]
[  ][  ][Hr][Wd][  ][  ][  ][Wr][Hd][B ][  ][  ][B ][B ][  ][  ]
[  ][  ][  ][  ][B ][Hl][  ][Wr][  ][  ][  ][Wl][  ][B ][  ][  ]
[Wr][  ][  ][B ][B ][Wu][  ][B ][  ][Hu][Wl][Wd][Wr][Hr][Hr][  ]
