[  ][  ][  ][  ][Hu][  ][  ][Wr][  ][  ][  ][  ][  ][Wd][  ][  ]
[B ][Wu][B ][  ][  ][B ][  ][B ][  ][Hl][  ][  ][  ][B ][Hl][Wr]
[Hu][B ][Wd][  ][  ][Hu][Wu][Hr][Hu][Wr][  ][  ][  ][  ][  ][Wu]
[  ][Wr][  ][  ][  ][Wr][  ][  ][Wu][B ][  ][  ][Ex][Hu][  ][  ]
[Hd][B ][  ][  ][  ][  ][Hr][Wr][  ][  ][  ][  ][  ][B ][Wu][  ]
[Hd][  ][  ][Hd][Wl][  ][  ][  ][Wu][  ][  ][  ][  ][B ][  ][Hr]
[Wl][Hd][  ][  ][  ][  ][B ][  ][  ][B ][  ][  ][D ][  ][  ][  ]
[  ][  ][  ][Wu][B ][  ][  ][  ][B ][  ][Hl][  ][  ][B ][B ][B ]
[  ][  ][Hl][Hl][B ][Wl][Hu][  ][  ][  ][  ][Wu][B ][  ][Hd][  ]
