[  ][  ][  ][  ][  ][  ][Wd][  ][  ][  ][  ][  ][  ][  ][Wd][  ]
[  ][  ][  ][  ][Hd][Hu][B ][  ][Hu][  ][  ][D ][  ][  ][  ][  ]
[  ][  ][  ][  ][  ][B ][B ][  ][  ][  ][  ][  ][  ][  ][  ][  ]
[Wd][  ][  ][  ][  ][  ][  ][  ][  ][  ][Hd][  ][  ][  ][Hd][  ]
[  ][  ][  ][B ][Wu][  ][  ][  ][  ][  ][  ][  ][Ex][Wu][  ][  ]
[Wl][  ][Wu][  ][  ][  ][  ][  ][  ][  ][Wr][  ][  ][  ][  ][Hu]
[  ][  ][  ][  ][  ][B ][Wd][Hl][  ][  ][  ][  ][  ][  ][  ][B ]
[  ][  ][  ][  ][  ][  ][B ][  ][  ][  ][  ][Wl][  ][  ][  ][  ]
[  ][  ][  ][Hl][  ][Hd][  ][  ][  ][  ][  ][  ][  ][  ][  ][  ]
