[Wr][B ][  ][Wu][  ][Wu][  ][Wu][Hr][  ][Hu][  ][Wu][B ][  ][Wd]
[B ][  ][Hr][  ][  ][  ][  ][B ][  ][Hd][  ][  ][  ][Hd][  ][  ]
[Wl][  ][B ][  ][  ][Hu][B ][  ][B ][  ][  ][  ][B ][  ][Hd][  ]
[Hd][B ][  ][  ][Wr][B ][  ][  ][D ][  ][  ][  ][  ][Hu][Wd][  ]
[  ][  ][  ][  ][  ][B ][  ][B ][  ][  ][  ][  ][  ][  ][  ][B ]
[  ][  ][Wr][  ][  ][  ][  ][Ex][  ][  ][  ][  ][  ][Wd][  ][Wu]
[  ][  ][B ][  ][  ][Hl][  ][  ][  ][Wr][B ][B ][B ][  ][  ][  ]
[  ][  ][  ][  ][  ][  ][  ][  ][  ][  ][  ][Wr][  ][Wd][  ][Hl]
[  ][  ][  ][B ][  ][Wd][Hr][  ][B ][  ][  ][Hu][  ][B ][Hr][  ]
