[  ][  ][  ][B ][  ][  ][  ][  ][Hr][  ][  ][  ][Hl][B ][  ][  ]
[  ][Hr][Wu][  ][Hd][  ][  ][  ][  ][  ][Hl][B ][  ][  ][  ][  ]
[Wl][  ][B ][  ][B ][  ][  ][  ][  ][  ][Hr][Wr][Hu][  ][  ][  ]
[  ][  ][Wd][  ][  ][Hl][  ][  ][D ][  ][Wd][  ][  ][Hu][Wd][  ]
[  ][  ][  ][  ][  ][  ][  ][  ][  ][Wd][  ][  ][  ][  ][  ][B ]
[  ][  ][Hu][Hd][  ][  ][  ][Ex][  ][  ][  ][Hu][  ][  ][Hl][  ]
[  ][  ][B ][  ][  ][Hl][  ][  ][  ][B ][Hl][B ][B ][  ][  ][  ]
[  ][  ][  ][  ][  ][  ][Hd][  ][  ][  ][  ][Hr][  ][Wd][Hd][  ]
[  ][  ][  ][B ][  ][B ][B ][  ][B ][Wd][B ][Hu][  ][B ][Hr][  ]
