[  ][  ][  ][  ][Hd][  ][Wd][  ][  ][  ][Hl][  ][Wr][  ][Wd][  ]
[  ][  ][  ][  ][Wr][B ][B ][  ][Hu][  ][  ][D ][B ][  ][  ][B ]
[  ][Wr][  ][  ][Hu][B ][B ][  ][  ][  ][  ][  ][  ][  ][  ][  ]
[Wd][Wr][  ][  ][B ][B ][  ][  ][Wu][  ][  ][  ][  ][  ][B ][  ]
[B ][  ][Wl][B ][Wu][  ][  ][  ][  ][B ][  ][  ][Ex][Wu][  ][  ]
[Wl][  ][  ][  ][  ][  ][  ][  ][  ][  ][Hd][  ][Wl][  ][  ][Hu]
[Wd][  ][  ][  ][  ][B ][Hl][Hd][  ][  ][  ][  ][  ][  ][  ][B ]
[  ][Hr][  ][  ][  ][  ][B ][  ][Wl][  ][  ][Wl][  ][Wd][  ][  ]
[  ][  ][  ][Hl][  ][Hd][Wd][  ][  ][  ][  ][  ][  ][  ][  ][  ]
