[  ][  ][  ][B ][  ][  ][  ][  ][Hr][  ][  ][  ][  ][B ][  ][  ]
[  ][  ][Wu][  ][  ][  ][  ][  ][  ][  ][  ][B ][  ][  ][  ][  ]
[Wl][B ][B ][  ][  ][  ][  ][  ][  ][  ][  ][  ][Hu][  ][  ][  ]
[  ][Hu][Wd][  ][  ][Hd][  ][  ][D ][  ][Wd][  ][  ][Hu][Wd][  ]
[  ][  ][  ][  ][  ][B ][  ][  ][  ][  ][  ][  ][  ][  ][  ][B ]
[  ][  ][Hu][  ][  ][  ][  ][Ex][  ][  ][  ][  ][  ][  ][  ][  ]
[  ][  ][B ][  ][  ][Hl][  ][  ][  ][B ][Hl][B ][B ][  ][  ][  ]
[  ][  ][  ][  ][  ][  ][Hd][  ][  ][  ][  ][Wl][  ][Wd][Hd][  ]
[  ][  ][  ][B ][  ][  ][B ][  ][B ][  ][  ][Hu][  ][B ][Hr][  ]
