[  ][  ][  ][B ][  ][Hu][  ][  ][Hr][  ][  ][  ][  ][B ][  ][  ]
[  ][  ][Wr][Wd][  ][Wr][Wd][  ][  ][  ][  ][B ][  ][  ][  ][Hu]
[Wl][  ][B ][  ][  ][Hd][Wd][  ][  ][  ][  ][  ][Hu][  ][  ][Wu]
[Hd][Hu][Wd][  ][  ][Hd][  ][  ][D ][  ][Wd][  ][Hu][Hu][Wd][  ]
[  ][  ][  ][  ][  ][B ][B ][  ][  ][  ][Wl][  ][  ][B ][  ][B ]
[  ][Wr][  ][  ][  ][  ][Wl][Ex][  ][  ][  ][  ][B ][  ][  ][Wu]
[  ][B ][B ][  ][  ][Wu][  ][  ][  ][Wr][Hl][B ][B ][  ][  ][  ]
[  ][  ][  ][  ][  ][  ][Hd][Wl][  ][  ][  ][Wl][Wr][Hr][B ][  ]
[  ][  ][  ][B ][  ][  ][B ][  ][B ][  ][  ][Wd][  ][B ][Wl][  ]
