[  ][Wr][B ][  ][Hl][Hu][Hd][  ][Wu][  ][Hr][B ][Wr][Hd][  ][B ]
[  ][B ][B ][Wd][  ][  ][B ][B ][B ][  ][  ][B ][  ][B ][  ][Hu]
[B ][  ][  ][  ][  ][  ][  ][  ][Wl][  ][  ][B ][  ][  ][  ][B ]
[  ][  ][Wd][  ][  ][Wr][Wu][  ][D ][  ][Wl][  ][  ][  ][  ][Hu]
[  ][Hu][  ][B ][  ][B ][  ][Wl][  ][  ][  ][  ][  ][  ][  ][B ]
[  ][  ][  ][B ][  ][  ][Hl][Ex][  ][  ][  ][Wl][  ][  ][  ][Wu]
[  ][  ][Hr][Wd][  ][Hl][  ][Wr][  ][B ][  ][  ][B ][B ][B ][  ]
[  ][  ][  ][  ][B ][Hl][Hd][Wr][  ][  ][  ][Wl][  ][B ][  ][Wl]
[Wr][Hr][  ][B ][B ][Wu][B ][B ][B ][Hu][Wl][Wd][Wr][Hr][Hr][  ]
