[  ][B ][B ][Hr][Hl][Hu][  ][  ][Wu][  ][Hr][B ][Wr][Hd][  ][B ]
[  ][B ][Hr][Wd][  ][  ][B ][B ][  ][  ][  ][B ][  ][Wu][  ][Hu]
[B ][  ][  ][  ][  ][  ][  ][  ][  ][  ][  ][B ][  ][  ][  ][B ]
[  ][Wd][Wd][  ][  ][Wr][Wu][  ][D ][  ][  ][  ][  ][  ][  ][Hu]
[  ][Hu][  ][B ][  ][B ][  ][Wl][  ][  ][  ][  ][  ][  ][  ][B ]
[  ][  ][  ][B ][  ][  ][Hl][Ex][  ][  ][  ][Hd][  ][  ][  ][Wu]
[  ][  ][Hr][Wd][  ][Hl][  ][B ][  ][  ][  ][B ][B ][B ][  ][  ]
[  ][  ][  ][  ][  ][Hl][Hd][Wr][  ][  ][  ][Wl][  ][B ][  ][  ]
[Wr][Hr][  ][B ][B ][Wu][B ][B ][B ][Hu][Wl][Wd][Wr][Hr][Hr][  ]
