[  ][  ][  ][B ][  ][  ][  ][  ][Hr][  ][  ][  ][  ][B ][  ][  ]
[  ][  ][Wu][Wd][  ][  ][  ][  ][  ][  ][  ][B ][  ][  ][  ][  ]
[Wl][B ][B ][  ][  ][  ][  ][  ][  ][  ][  ][  ][Hu][  ][  ][  ]
[  ][Hu][Wd][  ][  ][Hd][  ][  ][D ][  ][Wd][  ][  ][Hu][Wd][  ]
[  ][  ][  ][  ][  ][B ][  ][  ][  ][  ][  ][  ][  ][  ][  ][B ]
[  ][  ][  ][  ][  ][  ][  ][Ex][  ][  ][  ][  ][  ][  ][  ][  ]
[  ][  ][B ][  ][  ][Hl][  ][  ][  ][Wr][Hl][B ][B ][  ][  ][  ]
[  ][  ][  ][  ][  ][  ][Hd][  ][  ][  ][  ][Wl][  ][Wd][Hd][  ]
[  ][  ][  ][B ][  ][  ][B ][  ][B ][  ][  ][Hu][  ][B ][Hr][  ]
