[  ][  ][  ][B ][  ][Hu][  ][  ][Hr][  ][  ][  ][  ][B ][  ][  ]
[  ][  ][Hr][Wd][  ][Wr][Wd][  ][  ][  ][  ][B ][  ][  ][  ][  ]
[Wl][  ][B ][  ][  ][  ][Wd][  ][  ][  ][  ][  ][Hu][  ][  ][  ]
[Hd][Hu][Wd][  ][  ][Hd][  ][  ][D ][  ][Wd][  ][  ][Hu][Wd][  ]
[  ][  ][  ][  ][  ][B ][  ][  ][  ][  ][  ][  ][  ][  ][  ][B ]
[  ][Wr][  ][  ][  ][  ][  ][Ex][  ][  ][  ][  ][  ][  ][  ][Wu]
[  ][B ][B ][  ][  ][Hl][  ][  ][  ][Wr][Hl][B ][B ][  ][  ][  ]
[  ][  ][  ][  ][  ][  ][Hd][  ][  ][  ][  ][Wl][  ][Wd][Hd][  ]
[  ][  ][  ][B ][  ][  ][B ][  ][B ][  ][  ][Wd][  ][B ][  ][  ]
