[  ][  ][  ][  ][Hd][  ][Wd][  ][  ][  ][Hl][  ][Wr][  ][Wd][  ]
[  ][  ][  ][  ][Wr][B ][B ][  ][Hu][  ][  ][D ][B ][  ][  ][B ]
[  ][Wr][  ][  ][Hu][B ][B ][  ][  ][  ][  ][Wu][  ][  ][  ][  ]
[Wd][Wr][  ][  ][  ][  ][  ][  ][Wu][  ][  ][  ][  ][  ][B ][  ]
[B ][  ][Wl][B ][Wu][  ][  ][  ][  ][B ][  ][  ][Ex][Wu][  ][  ]
[Wl][  ][  ][  ][  ][  ][  ][  ][  ][  ][Hd][  ][Wl][  ][  ][Hu]
[Wd][  ][  ][  ][  ][B ][Hl][Hd][  ][  ][  ][  ][  ][  ][  ][B ]
[  ][B ][  ][  ][  ][  ][B ][  ][Wl][  ][  ][Wl][  ][Wd][  ][  ]
[  ][  ][  ][Hl][  ][Hd][Wd][  ][  ][  ][  ][  ][  ][  ][  ][  ]
