[  ][  ][  ][  ][  ][  ][  ][  ][  ][  ][  ][Wr][  ][  ][  ][  ]
[  ][  ][  ][  ][  ][B ][  ][B ][  ][  ][  ][  ][  ][B ][  ][Wr]
[Hu][  ][  ][  ][  ][  ][  ][Hu][Hu][  ][  ][  ][  ][  ][  ][B ]
[  ][  ][  ][  ][  ][Wr][  ][  ][  ][  ][  ][  ][Ex][Hu][  ][  ]
[  ][  ][  ][  ][  ][  ][Wd][Wr][B ][  ][  ][  ][  ][B ][  ][  ]
[  ][  ][Wr][  ][  ][  ][  ][  ][  ][  ][  ][  ][  ][  ][  ][  ]
[  ][  ][  ][  ][  ][  ][B ][  ][  ][B ][  ][  ][D ][  ][  ][  ]
[  ][  ][  ][Hd][B ][  ][  ][  ][B ][Hr][Hl][  ][  ][B ][B ][B ]
[  ][  ][  ][  ][Wd][Wl][B ][  ][  ][  ][  ][Wu][  ][  ][  ][  ]
