[  ][  ][B ][B ][Hl][Hu][  ][  ][Wu][  ][Hr][B ][  ][Hd][  ][B ]
[  ][  ][Hr][Wd][  ][Wr][  ][B ][  ][  ][  ][B ][  ][Wu][  ][Hu]
[Wl][  ][  ][  ][  ][  ][  ][  ][  ][  ][  ][B ][  ][  ][  ][B ]
[  ][Wd][Wd][  ][  ][  ][Wu][Wl][D ][  ][Wd][  ][  ][  ][  ][Hu]
[  ][  ][  ][B ][  ][B ][  ][  ][  ][  ][  ][  ][  ][  ][  ][B ]
[  ][  ][  ][  ][  ][  ][Hl][Ex][  ][  ][Wd][  ][  ][  ][  ][Wu]
[  ][  ][B ][Wu][  ][Hl][  ][  ][  ][  ][  ][B ][B ][B ][B ][  ]
[  ][  ][  ][  ][  ][  ][Hd][  ][  ][  ][  ][Wl][  ][Wd][  ][  ]
[Wr][  ][  ][B ][  ][Hd][  ][  ][B ][  ][Wl][Wd][Hd][B ][Hr][  ]
