[  ][  ][B ][Hr][Hl][Hu][  ][  ][Wu][  ][Hr][B ][  ][Hd][  ][B ]
[  ][  ][Hr][Wd][  ][Wr][  ][B ][  ][  ][  ][B ][  ][Wu][  ][Hu]
[B ][  ][  ][  ][  ][  ][  ][  ][  ][  ][  ][B ][  ][  ][  ][  ]
[  ][Wd][Wd][  ][  ][  ][Wu][Wl][D ][  ][  ][  ][  ][  ][  ][Hu]
[  ][  ][  ][B ][  ][B ][  ][Wl][  ][  ][  ][  ][  ][  ][  ][B ]
[  ][  ][  ][  ][  ][  ][Hl][Ex][  ][  ][  ][Wu][  ][  ][  ][Wu]
[  ][  ][  ][  ][  ][Hl][  ][  ][  ][  ][  ][B ][B ][B ][B ][  ]
[  ][  ][  ][  ][  ][  ][Hd][  ][  ][  ][  ][Wl][  ][Wd][  ][  ]
[Wr][  ][  ][B ][  ][Hd][B ][  ][B ][  ][Wl][Wd][Hd][B ][Hr][  ]
