[  ][  ][  ][B ][  ][  ][  ][  ][Hr][  ][  ][  ][  ][B ][  ][  ]
[  ][  ][Wu][Wd][  ][  ][  ][  ][  ][  ][  ][B ][  ][  ][  ][  ]
[Wl][B ][B ][  ][  ][  ][  ][  ][  ][  ][  ][  ][Hu][  ][  ][  ]
[  ][Hu][Wd][Hl][  ][Hd][  ][  ][D ][  ][  ][  ][  ][Hu][Wd][  ]
[  ][  ][  ][  ][  ][B ][  ][  ][  ][  ][  ][  ][  ][  ][  ][B ]
[  ][  ][  ][  ][  ][  ][  ][Ex][Hr][  ][  ][  ][  ][  ][  ][  ]
[  ][  ][  ][  ][  ][Hl][  ][  ][  ][Wr][Hl][B ][B ][  ][  ][  ]
[  ][  ][  ][  ][  ][  ][Hd][  ][  ][  ][  ][Wl][  ][Wd][Hd][  ]
[  ][  ][  ][B ][  ][  ][B ][  ][B ][  ][  ][Hu][  ][B ][Hr][  ]
