[D ][  ][  ][  ][  ][  ][  ][  ][  ][  ][  ][  ][  ][  ][Hl][  ]
[  ][  ][  ][  ][  ][  ][  ][  ][  ][B ][  ][  ][  ][  ][  ][  ]
[  ][  ][Hr][  ][B ][  ][  ][  ][  ][  ][  ][  ][  ][  ][  ][  ]
[  ][  ][  ][  ][  ][  ][  ][  ][  ][  ][  ][  ][  ][Wd][  ][  ]
[  ][Hr][  ][  ][  ][  ][  ][  ][  ][  ][  ][  ][Hr][  ][  ][  ]
[Wr][  ][  ][  ][  ][  ][  ][  ][  ][  ][  ][  ][  ][  ][  ][  ]
[  ][  ][  ][  ][  ][B ][  ][  ][  ][Hl][  ][  ][B ][  ][  ][  ]
[  ][  ][B ][  ][Hl][  ][  ][  ][  ][  ][  ][Hu][Wl][  ][  ][  ]
[  ][  ][B ][  ][  ][  ][Wd][  ][  ][  ][  ][  ][  ][  ][  ][Ex]
