[D ][  ][  ][  ][  ][  ][Wd][  ][  ][  ][  ][  ][  ][  ][Wu][  ]
[  ][  ][Hu][  ][  ][  ][  ][  ][  ][  ][Wd][Wu][  ][  ][  ][  ]
[  ][  ][B ][  ][Hl][  ][  ][  ][B ][  ][  ][B ][  ][  ][  ][  ]
[Wu][  ][  ][  ][  ][  ][  ][  ][  ][  ][  ][  ][  ][Wd][  ][  ]
[  ][Hr][  ][  ][  ][  ][  ][  ][  ][  ][  ][  ][  ][Hr][  ][Wu]
[  ][  ][  ][  ][  ][Hd][  ][  ][  ][  ][  ][  ][  ][  ][  ][  ]
[Wu][  ][  ][  ][  ][  ][  ][  ][  ][  ][Hd][  ][  ][  ][  ][  ]
[  ][  ][Wl][  ][  ][  ][  ][  ][Wu][  ][  ][  ][Wl][Wd][  ][  ]
[  ][  ][  ][  ][  ][  ][  ][  ][  ][  ][  ][  ][  ][Hd][  ][Ex]
