[D ][  ][  ][  ][  ][  ][  ][  ][  ][  ][  ][  ][  ][  ][  ][  ]
[  ][  ][  ][  ][  ][  ][  ][  ][  ][B ][B ][Wu][  ][  ][  ][  ]
[Hd][  ][B ][  ][Hl][B ][  ][  ][  ][B ][B ][  ][  ][  ][  ][  ]
[  ][B ][  ][  ][  ][  ][  ][  ][  ][  ][  ][  ][  ][  ][  ][  ]
[  ][Hr][  ][  ][B ][  ][  ][  ][  ][  ][  ][  ][  ][Wl][  ][  ]
[  ][  ][  ][  ][B ][Hd][  ][  ][  ][  ][  ][  ][  ][  ][  ][  ]
[Wu][  ][  ][  ][  ][  ][Wr][  ][  ][  ][  ][  ][  ][  ][B ][  ]
[Wu][  ][Wl][  ][B ][  ][  ][  ][B ][  ][  ][  ][  ][  ][  ][  ]
[  ][  ][  ][  ][  ][  ][  ][  ][  ][  ][Wu][Hd][  ][Hd][  ][Ex]
