[D ][  ][  ][  ][  ][  ][  ][  ][  ][  ][  ][  ][  ][  ][  ][  ]
[  ][  ][Wu][  ][B ][  ][  ][  ][  ][  ][  ][  ][  ][B ][  ][  ]
[  ][  ][Hr][  ][  ][  ][  ][B ][B ][B ][  ][  ][  ][  ][Hr][  ]
[  ][B ][  ][  ][  ][  ][  ][  ][B ][Wr][  ][  ][  ][B ][  ][  ]
[  ][  ][  ][  ][  ][  ][  ][  ][  ][  ][  ][  ][  ][  ][  ][  ]
[Hu][  ][B ][  ][  ][  ][Wl][  ][  ][  ][  ][  ][  ][  ][  ][  ]
[Wu][  ][  ][  ][  ][  ][  ][  ][  ][  ][  ][  ][  ][  ][  ][  ]
[  ][  ][  ][  ][  ][  ][  ][  ][B ][  ][  ][Wd][  ][  ][  ][  ]
[  ][  ][  ][  ][  ][  ][  ][B ][  ][  ][B ][Hd][  ][Hd][  ][Ex]
