[D ][  ][Hu][  ][  ][  ][  ][  ][  ][  ][  ][  ][  ][  ][  ][  ]
[  ][  ][  ][  ][  ][B ][  ][  ][  ][B ][  ][  ][  ][Hr][  ][  ]
[  ][  ][  ][  ][B ][  ][  ][  ][  ][Wu][  ][  ][  ][B ][  ][  ]
[  ][  ][  ][  ][  ][  ][  ][  ][  ][  ][  ][  ][  ][Wd][  ][  ]
[  ][Hr][  ][Wd][Hr][  ][  ][  ][  ][B ][  ][B ][Hr][  ][  ][  ]
[  ][  ][  ][  ][  ][  ][  ][  ][  ][  ][  ][  ][  ][  ][  ][  ]
[  ][  ][  ][  ][  ][  ][  ][  ][  ][Hl][  ][  ][B ][  ][  ][  ]
[  ][  ][B ][  ][B ][  ][  ][  ][  ][  ][  ][Hu][  ][B ][  ][  ]
[  ][  ][  ][  ][  ][  ][Wd][  ][  ][Hd][  ][  ][  ][  ][  ][Ex]
