[D ][  ][Wr][  ][  ][  ][  ][  ][  ][  ][  ][  ][  ][  ][Wd][  ]
[  ][  ][Wu][  ][  ][  ][  ][  ][  ][  ][  ][Wu][  ][  ][  ][  ]
[  ][  ][B ][  ][  ][B ][  ][  ][B ][B ][  ][  ][  ][  ][  ][  ]
[  ][B ][Hu][Hl][  ][  ][  ][  ][  ][  ][  ][  ][  ][B ][  ][  ]
[  ][Hr][  ][  ][B ][  ][  ][  ][  ][  ][  ][  ][  ][  ][  ][  ]
[  ][  ][B ][  ][B ][  ][  ][  ][  ][  ][  ][  ][B ][  ][  ][  ]
[Wu][  ][  ][  ][  ][  ][  ][  ][  ][  ][  ][  ][  ][  ][B ][  ]
[Wu][  ][Wl][  ][B ][  ][  ][  ][  ][  ][  ][Wd][  ][  ][  ][  ]
[  ][  ][  ][  ][  ][  ][  ][  ][  ][  ][Wu][Hd][  ][Hd][  ][Ex]
