[D ][  ][Hu][  ][Wd][  ][  ][  ][  ][  ][  ][  ][  ][  ][Wu][  ]
[  ][  ][  ][  ][  ][  ][  ][  ][  ][  ][Wd][  ][  ][  ][  ][  ]
[  ][  ][  ][  ][Hl][  ][  ][  ][  ][  ][  ][B ][  ][  ][  ][  ]
[  ][  ][  ][  ][  ][  ][  ][  ][  ][  ][  ][  ][  ][Wd][  ][  ]
[  ][Hr][  ][  ][  ][  ][  ][  ][  ][  ][Hl][  ][Hr][  ][Wu][  ]
[  ][  ][  ][Hl][  ][Hd][  ][  ][  ][  ][Wu][  ][Wd][  ][  ][  ]
[  ][  ][  ][  ][  ][  ][  ][  ][  ][  ][  ][  ][  ][  ][Wl][  ]
[  ][  ][Wl][  ][  ][  ][  ][  ][B ][  ][  ][  ][Wl][  ][  ][  ]
[  ][  ][B ][  ][  ][  ][Wr][  ][  ][  ][  ][  ][  ][  ][  ][Ex]
