[D ][  ][  ][  ][  ][  ][  ][  ][  ][  ][Wl][  ][  ][  ][Wd][  ]
[  ][  ][  ][  ][  ][  ][  ][  ][  ][  ][  ][Wu][  ][  ][  ][  ]
[  ][  ][B ][  ][Hl][B ][  ][B ][B ][B ][  ][  ][B ][  ][  ][  ]
[  ][B ][  ][  ][  ][  ][  ][  ][  ][  ][  ][  ][  ][B ][  ][  ]
[  ][Hr][  ][  ][B ][  ][  ][  ][  ][  ][  ][  ][  ][  ][  ][  ]
[  ][  ][  ][  ][  ][Hd][  ][  ][  ][  ][  ][  ][B ][  ][  ][  ]
[Wu][  ][  ][  ][  ][  ][  ][  ][  ][  ][  ][  ][  ][  ][B ][  ]
[Wu][  ][Wl][  ][B ][  ][  ][  ][B ][  ][  ][Wd][  ][  ][  ][  ]
[  ][Hu][  ][  ][  ][  ][  ][  ][  ][  ][Wu][Hd][  ][Hd][  ][Ex]
