[D ][  ][Hu][  ][Wd][  ][  ][  ][B ][  ][  ][  ][  ][  ][B ][  ]
[  ][  ][  ][  ][  ][  ][  ][  ][  ][  ][Wd][  ][  ][  ][  ][  ]
[  ][  ][  ][  ][B ][  ][  ][  ][  ][  ][  ][  ][  ][  ][  ][  ]
[  ][  ][  ][  ][  ][  ][  ][  ][  ][  ][  ][  ][  ][Wd][  ][  ]
[  ][Hr][  ][  ][Hr][  ][  ][  ][  ][  ][  ][  ][Hr][Hr][Hu][  ]
[  ][  ][  ][  ][  ][Hd][  ][  ][Wr][  ][  ][  ][  ][  ][  ][  ]
[  ][  ][  ][  ][  ][  ][  ][  ][  ][  ][  ][  ][  ][  ][  ][  ]
[  ][  ][  ][  ][Hl][  ][  ][  ][  ][  ][  ][  ][Wl][  ][  ][  ]
[  ][  ][B ][  ][  ][  ][Wd][  ][  ][  ][Wu][  ][  ][  ][  ][Ex]
